type octile
height 39
width 127
map
@@@@....@@@@@@@@@@@..........@@@@@........................................@@@@..@@@@@@....@@@........@@@@@@@@@@@@@@@@@@@@@@@@@@
@@@@......@@@@@@@@............@@@..........@@@@@@@.......................@@@@..@@@@@@@...@@@@.........@@@@@@@@@@@@@@@@@@@@@@@@@
@@@@@......@@@@@@.........................@@@@@@........................@@@@..@@@@@@@...@@@@...........@@@@@@@@@@@@@@@@@@@@@@@@
@@@@@.......@@@@@@@......................@@@@@@....................@@...@@@....@@@@@...@@@@.............@@@@@@@@@@@@@@@@@@@@@@@
@@@@.........@@@@@@.....................@@@@@@....................@@@@...@......@@@...@@@@................@@@@@@@@@@@@@@@@@@@@@
@@@.....@.....@@@@@@...................@@@@@@....................@@@@@@..............@@@@..................@@@@@@@@@@@@@@@@@@@@
@@.....@@@.....@@@@@..................@@@@@@@........@.@@.......@@@..@@@............@@@@..@@@................@@@@@@@@@@@@@@@@@@
......@@@@@.....@@@@.................@@@@@..........@@@@@@.....@@@....@@@..........@@@@@@@@@@@................@@@@@@@@@@@@@@@@@
......@@@@@@.....@..................@@@@@...........@@@@@@....@@@......@@@........@@@@@@@@@@@@.......@.........@@@@@@@@@@@@@@@@
.......@@@@@@........@@@...........@@@@@...........@@@@@@....@@@........@@@......@@@@.@@@@@@@@@.....@@@.........@@@@@@@@@@@@@@@
........@@@@@........@@@@.........@@@@@@............@@@@....@@@..........@@@....@@@@..@.@@@@@@@....@@@@..........@@@@@@@@@@@@@@
@........@@@..@......@@@@@.......@@@@@@@.............@@....@@@............@@@...@@@.....@@@@@@....@@@@............@@@@@@@@@@@@@
@@........@..@@@.......@@@@.....@@@@@@@@@.................@@@..............@@....@.......@@@@....@@@@.............@@@@@@@@@@@@@
@@@.........@@@@@.......@@@@...@@@@@@@@...................@@...............@@@............@@....@@@@.............@@@@@@@@@@@@@@
@@@@........@@@@@@.......@@@@.@@@@@@@@...................@@.........@@......@@@................@@@@.............@@@@@@@@@@@@@@@
@@@@@.........@@@@.......@@@@@@@@@@@@...................@@@.........@@@.....@@@...............@@@@.............@@@@@@@.@@@@@@@@
@@@@@@.........@@.......@@@@@@@@@@@@......@@...........@@@@..........@@......@...............@@@@.............@@@@@@....@@@@@@@
@@@@@@@................@@@@@@@@@@@@......@@@@.........@@@@@@.........@@.....................@@@@.............@@@@@@@...@@@@@@@@
@@@@@@@@..............@@@@@@@@@@@@......@@@@@@........@@@@@@@........@@@.....@@............@@@@.............@@@@@@@@...@@@@@@@@
@@@@@@@@@............@@@@@@@@@@@@@.....@@@@@@@@@......@@@@@@@@@@....@@@@.....@@...........@@@@.............@@@@@@@@@....@@@@@@@
@@@@@@@@@@..........@@@@@@@@@@@@@@....@@@@@@@@@@@......@@@@@@@@@@@@@@..@@.................@@@.............@@@@@@@@.......@@@@@@
@@@@@@@@@@@........@@@@@@@@@@@@....@@@@@@@@@@@@@@@......@@@@@@@@@@.....@@..................@.............@@@@@@@@.........@@@@@
@@@@@@@@@@@@......@@@@@@@@@@@@.....@@@@@@@@@@@@@@@.......@@@@@@@@.......@...............................@@@@@@@@@..........@@@@
@@@@@@@@@@@@@....@@@@@@@@@@@@......@@@@@@@@@@@@@@..........@@@@@.......................................@@@@@@@@.............@@@
@@@@@@@@@@@@@@..@@@@@@@@@.@@........@@@@@@@@@@@@............@@@.......................................@@@@@@@@...............@@
@@@@@@@@@@@@@@@@@@@@@@@@@............@@@@@@@@@@.....@@.......@.......................................@@@@@@@@.................@
@@@@@@@@@@@@@@@@@@@@@@@@@............@@@@@@@@@.....@@@@@............................................@@@@@@@@...................
@@@@@@@@@@@@@@@@@@@@@@@...............@@@@@@......@@@@@@@..........................................@@@@@@@@....................
@@@@@@@@@@@@@@@@@@@@@@...............@@@@@@@.....@@@@@@@@@........................................@@@@@@@@..........@..........
@@@@@@@@@@@@@@@@@@@@@...............@@@@@@@@....@@@@@@@@@@@......................................@@@@@@@@..........@@@.........
@@@@@@@@@@@@@@@@@@@@...............@@@@@@@@@....@@@@@@@@@@@@....................................@@@@@@@@..........@@@@@........
@@@@@@@@@@@@@@@@@@@@@.............@@@@@@@.....@@@@@@@@@@@@@@@..................................@@@@@@@@............@@@@........
@@@@@@@@@@@@@@@@@@@@@@...........@@@@@@@.....@@@@@@@@@@@@@@@..................................@@@@@@@@..............@@.........
@@@@@@@@@@@@@@@@@@@@@@@.........@@@@@@@@......@@@@@@@@@@@@....................................@@@@@@@..........................
@@@@@@@@@@@@@@@@@@@@@@@@......@@@@@@...........@@@@@@@@@@.....@@...............................@@.@@@.....@....................
@@@@@@@@@@@@@@@@@@@@@@@@@....@@@@@@@...........@@@@@@@@@.....@@@@...............................@........@@@..................@
@@@@@@@@@@@@@@@@@@@@@@@@@@..@@@@@@@.............@@@@@@@.....@@@@@@......................................@@@@@................@@
@@@@@@@@@@@@@@@@@@@@@@@@@@@@@@@@@@..............@@@@@@.....@@@@@@@@......................................@@@@@..............@@@
@@@@@@@@@@@@@@@@@@@@@@@@@@@@@@@@...............@@@@@@@....@@@@@@@@@@......................................@@@@@............@@@@
