type octile-corner
height 161
width 161
map
OOOOOOOOOOOOOOOOOOOOOOOOOOOOOOOOOOOOOOOOOOOOOOOOOOOOOOOOOOOOOOOOOOOOOOOOOOOOOOOOOOOOOOOOOOOOOOOOOOOOOOOOOOOOOOOOOOOOOOOOOOOOOOOOOOOOOOOOOOOOOOOOOOOOOOOOOOOOOOOOO
OOOOOOOOOOOOOOOOOOOOOOOOOOOOOOOOOOOOOOOOOOOOOOOOOOOOOOOOOOOOOOOOOOOOOOOOOOOOOOOOOOOOOOOOOOOOOOOOOOOOOOOOOOOOOOOOOOOOOOOOOOOOOOOOOOOOOOOOOOOOOOOOOOOOOOOOOOOOOOOOO
OOOOOOOOOOOOOOOOOOOOOOOOOOOOOOOOOOOOOOOOOOOOOOOOOOOOOOOOOOOOOOOOOOOOOOOOOOOOOOOOOOOOOOOOOOOOOOOOOOOOOOOOOOOOOOOOOOOOOOOOOOOOOOOOOOOOOOOOOOOOOOOOOOOOOOOOOOOOOOOOO
OOOOOOOOOOOOOOOOOOOOOOOOOOOOOOOOOOOOOOOOOOOOOOOOOOOOOOOOOOOOOOOOOOOOOOOOOOOOOOOOOOOOOOOOOOOOOOOOOOOOOOOOOOOOOOOOOOOOOOOOOOOOOOOOOOOOOOOOOOOOOOOOOOOOOOOOOOOOOOOOO
OOOOOOOOOOOOOOOOOOOOOOOOOOOOOOOOOOOOOOOOOOOOOOOOOOOOOOOOOOOOOOOOOOOOOOOOOOOOOOOOOOOOOOOOOOOOOOOOOOOOOOOOOOOOOOOOOOOOOOOOOOOOOOOOOOOOOOOOOOOOOOOOOOOOOOOOOOOOOOOOO
OOOOOOOOOOOOOOOOOOOOOOOOOOOOOOOOOOOOOOOOOOOOOOOOOOOOOOOOOOOOOOOOOOOOOOOOOOOOOOOOOOOOOOOOOOOOOOOOOOOOOOOOOOOOOOOOOOOOOOOOOOOOOOOOOOOOOOOOOOOOOOOOOOOOOOOOOOOOOOOOO
OOOOOOOOOOOOOOOOOOOOOOOOOOOOOOOOOOOOOOOOOOOOOOOOOOOOOOOOOOOOOOOOOOOOOOOOOOOOOOOOOOOOOOOOOOOOOOOOOOOOOOOOOOOOOOOOOOOOOOOOOOOOOOOOOOOOOOOOOOOOOOOOOOOOOOOOOOOOOOOOO
OOOOOOOOOOOOOOOOOOOOOOOOOOOOOOOOOOOOOOOOOOOOOOOOOOOOOOOOOOOOOOOOOOOOOOOOOOOOOOOOOOOOOOOOOOOOOOOOOOOOOOOOOOOOOOOOOOOOOOOOOOOOOOOOOOOOOOOOOOOOOOOOOOOOOOOOOOOOOOOOO
OOOOOOOOOOOOOOOOOOOOOOOOOOOOOOOOOOOOOOOOOOOOOOOOOOOOOOOOOOOOOOOOOOOOOOOOOOOOOOOOOOOOOOOOOOOOOOOOOOOOOOOOOOOOOOOOOOOOOOOOOOOOOOOOOOOOOOOOOOOOOOOOOOOOOOOOOOOOOOOOO
OOOOOOOOOOOOOOOOOOOOOOOOOOOOOOOOOOOOOOOOOOOOOOOOOOOOOOOOOOOOOOOOOOOOOOOOOOOOOOOOOOOOOOOOOOOOOOOOOOOOOOOOOOOOOOOOOOOOOOOOOOOOOOOOOOOOOOOOOOOOOOOOOOOOOOOOOOOOOOOOO
OOOOOOOOOOOOOOOOOOOOOOOOOOOOOOOOOOOOOOOOOOOOOOOOOOOOOOOOOOOOOOOOOOOOOOOOOOOOOOOOOOOOOOOOOOOOOOOOOOOOOOOOOOOOOOOOOOOOOOOOOOOOOOOOOOOOOOOOOOOOOOOOOOOOOOOOOOOOOOOOO
OOOOOOOOOOOOOOOOOOOOOOOOOOOOOOOOOOOOOOOOOOOOOOOOOOOOOOOOOOOOOOOOOOOOOOOOOOOOOOOOOOOOOOOOOOOOOOOOOOOOOOOOOOOOTTTOTOOOOOOOTTOOOOOOOOOOOOOOOOOOOOOOOOOOOOOOOOOOOOOOO
OOOOOOOOOOOOOOOOOOOOOOOOOOOOOOOOOOOOOOOOOOOOOOOOOOOOOOOOOOOOOOOOOOOOOOOOOOOOOOOOOOOOOOOOOOOOOOOOOOOOOOOOTOOOOOTTOTTOTTTTTTOOOOOOOOOOOOOOOOOOOOOOOOOOOOOOOOOOOOOOO
OOOOOOOOOOOOOOOOOOTOOTOOOOTOOOOOOOOOOOOOOOOOOOOOOOOOOOOOOOOOOOOOOOOOOOOOOOOOOOOOOOOOOOOOOOOOOOOOOOOOOOOOOOOOOTTOOOOOOOTTTTOOOOOOOOOOOOOOOOOOOOOOOOOOOOOOOOOOOOOOO
OOOOOOOOOOOOOOOOOTTTTTOOTTTOTOOOOOOOOOTOOOOOOOOOOOOOOOOOOOOOOOOOOOOOOOOOOOOOOOOOOOOOOTOOOTOOOTOOTOOOOOOOOOOOOOOOOOOOOOOOOOTOOOOOOOOOOOOOOOOOOOOOOOOOOOOOOOOOOOOOO
OOOOOOOOOOOOOOOOOOTTTTOOOTOOOOOOOOOOOOOOTOOOOOOOOOOOOOOOOOOOOOOOOOOOOOOOOOOOOOOOTOOOOOOOOOTOOTOOTOOOOOOOOOOOTTOOOOOOOOOOOOOOOOOOOOOOOOOOOOOOOOOOOOOOOOOOOOOOOOOOO
OOOOOOOOOOOOOOOOOOOTOOOTOOOTTOOOOOOOOOOTTOOOOOOOOOOOOOOOOOTTTTTOTTTOTOOOOOOOOOOOOOOOOOOOOOOOOOOOOOOOOOOOOOOOOOOOOOOOOOOOOOOOOOOOOOOOOOOOOOOOOOOOOOOOOOOOOOOOOOOOO
OOOOOOOOOOOOOOOOGTGGGGGGGGTTTGGGGGTTGGGTTGGWWWWWWWWGGGGGTTTTTTTTTTTTTGGGGGTGGGGGGTGGGWWWWWGGGTTGGGGGTTGGGGGGWWWWWWWWWWWWGTGGGGGGGGGGGGGGGGGGGGGGOOOOOOOOOOOOOOOOO
OOOOOOOOOOOOOOOOGGGGTTTTGGGGGGGGTGTTGGTGTTGGWWWWWWGGGGGTTTTTTTTTGTTTTTGGGGGGTGGGGTTTGGWWGGGTGGGTGGGGGGGGGGGGWWWWWWWWWWWSGTTTTTGGGTTGGGGTTGTTGGGGOOOOOOOOOOOOOOOOO
OOOOOOOOOOOOOOOOGGGTTGGGGGGGGTTGGGGGGGGTTTTGWWWWWGGGGGGGTTTTTTTTTTGTTGGGGGTTGGGTTTTTTGGGTTTTTGGGGGGGGGGGGTGWWWWWWWWWWWWGTTTTTTGGTGTTGGGGGGTGGGGGOOOOOOOOOOOOOOOOO
OOOOOOOOOOOOOOOOGGTGGGGGGGGGGGGTTGGTGTTTTTGWWWWWWGGGGTTTTTTTTTTTTTTTTTTTGGGGGGTGGTTTTTGGTTTTTTTGGGTGGGGGGTGWWWWWWWWWWWWGTTTTTTTGGGGGGGGGGGGTTTTTOOOOOOOOOOOOOOOOO
OOOOOOOOOOOOOOOOGGGGGGGGGGGGGGGGGTTTGTTTGWWWWWWWWTGTTTTTTTTTTTTTTTTTTTTTGGGGGTTGGGTTTGGTTTTTTTTTTTTTGGTTTGSWWWWWWWWWWWSTTTTGGTTGGGGGGTGGGGGGGGGGOOOOOOOOOOOOOOOOO
OOOOOOOOOOOOOOOOGGGGGGGGGGGGTTGGGTTTTGTGWWWWWWWWGGTTTTGTTTTTTTTTTGGTTTTTTTGGGTGGGGGTTGGGGGTTTTTTTTTTTTTTTGWWWWWSSWWWWWSGTTTGTTTGTTTTGGGGGGGTTGGGOOOOOOOOOOOOOOOOO
OOOOOOOOOOOOOOOTGGGGTTGGGGGGGTGGGGTTTGTGWWWWWWWGGTTTTGTTGTTTTTTGGGGGGTTTTTTTTTGGGGGGGGGGGGGGGGTTTTTTTTTTGWWWSWGGGGSGGGGTTTTGTGTTGTGGGGTGGGGTTTTGTOOOOOOOOOOOOOOOO
OOOOOOOOOOOOOOTOGGGGTGGGGGGGGGGGGGTTTTGWWWWWWWGTTTTGTTTTTTTTTGGGGGGGGGTTTTTTTTTGGGGGGGGGGGGGGTTTTTTTTGGGGSWWWWTTGGGGGGGGTTTGTTGTTTTTGGGGTGGGGGTGTOOOOOOOOOOOOOOOO
OOOOOOOOOOOOOOOOTGGGGGGGGGGGGGGGGGGTTTGWWWWWWGGTTTTTTGTTGTTGGGGGGGGGGGTTTTTTTTTTGGGGGGGGGGGGGGGTGTTGTGGGGGWWSGTTGGGTTGGGTTTGTTTTTTTGGGTGTGGGGGTGOOOOOOOOOOOOOOOOO
OOOOOOOOOOOOOOOOTTGGGGGGGGGGGGGGGGTTTTGGWWWWGTTTTTTTGTGTTTGGGGGGGGGGGGGTTTTTTTTGGGGGGGGGGGGGGGGGGGGTGGGGGGGGGGTTGGTTTGGGGTTTTTTTTTTGGGTTGGGGGGGGOOOOOOOOOOOOOOOOO
OOOOOOOOOOOOOOTTTTGGGGGGGGGGGGGGGGGTTTTGWWWWGTTTTTGTTTTGTTGGGGGGGGGGGGGTTTTTTGGGGGGGGGGGGGGGGGGGGGGGGGGGGGTTTTTTGGTTGGGGGTTTTTGGTTTGGTGGTGTGGGGGTOOOOOOOOOOOOOOOO
OOOOOOOOOOOOOOTTTTTTGGGGTGGGGGGGGGGGGTTGWWWGTTTTTTTTGTTTTTGGGGGGGGGGGGGTTTTTTGGGGGGGGGGGGGGGGGGGGGGGGGGGGTTTTTTTTGGGGGGGGGGGTGGGGGTTGGGGGGGGGTTTTOOOOOOOOOOOOOOOO
OOOOOOOOOOOOOOTTTTTTGGGGGGGGGGGGGGGGGTGWWWWGTTTTTGTTTTTTTTGGGGGGGGGGGGGTTTTTTGGGGGGGGGGGGGGGGGGGGGGGGGGGGTTTTTTTTTTGGGGGGGGGGGGGGTTTTGGGGGGGTTTTTOOOOOOOOOOOOOOOO
OOOOOOOOOOOOOOOOTTTTTTTGGGGGTTGGGGGGGGGWWWWTTGTTTTTTTTTTGGGGGGGGGGGGGGGGGTTTGGGGGGGGGGGGGGGGGGGGGGGGGGGGTTTTTTTTTTGGGGGGGGGGGGGGGTTTTTTTGGGTTTTGTOOOOOOOOOOOOOOOO
OOOOOOOOOOOOOOOOWSSTTTTTGGTTTTTTGGGGGGGGWWGGTTTTTTTTTTTGGGGGGGGGGGGGGGGGGGGGGGGGGGGGGGGGGGGGGGGGGGGGGGGGGTTTTTTTTTGGGGGGGGGGGGGGGTTGTTTGTTTGTGTTTOOOOOOOOOOOOOOOO
OOOOOOOOOOOOOOOOWWWWWWGTTTTTTTGTTGGGGGGGGWTTGTTTTGGGGGGGGGGGGGGGGGGGGGGGGGGGGGGGGGGGTTGGGTTTTTGGGGGGGGGGGTTTTTTTTGGGGGGGGGGGGGGTTTTTGTTTTTTTTGTTTOOOOOOOOOOOOOOOO
OOOOOOOOOOOOOOOOWWWWWWSTTTTGSSSGGGGGGGGGGGGTTTTGTGGGGGGGGGGGGGGGGGGGGGGGGGGGGGGGGGGTTTTTGTTTTTTGGGGGGGGGGGGTTTTGGGGGGGGGGGGGGGGTTTTGTTTTTTTTTTTTTOOOOOOOOOOOOOOOO
OOOOOOOOOOOOOOOOWWWWWWWWSSWWWWWWWWWGGGGGGGGTTTGTTGGGGGGGGGGGGGGGGGGGGGGGGGGGGGGGGGTTTTTTTTTGTTGGGGGGGGGGGGGGGGGGGGGGGGGGGGGGGGTTTTTTTTTGGGGTTTTTTOOOOOOOOOOOOOOOO
OOOOOOOOOOOOOOOOWWWWGWWWWWWWWWWWWWWWGGGGGGGGTTTTTGGGGGGGGGGGGGGGGGGGGGGGGGGGGGGTTTTGTTTTTTTTTTTTGGGGGGGGGGGGGGGGGGGGGGGGGGGGGGGTTTTTTTTGGGGGTTTTTOOOOOOOOOOOOOOOO
OOOOOOOOOOOOOOOOWWGGGGGWWWGGWWWWWWWWGGGGGGGGGTTTGGGGGGGGGGGGGGGGGGGGGGGGGGGGGGTTTTTTTTTTTTTTTTTTTTGGGGGGGGGGGGGGGGGGGGGGGGGGGGGTTTTTTGGGGGGGTTGTTOOOOOOOOOOOOOOOO
OOOOOOOOOOOOOOOOSGGTTTGGGGGGGGWWWWGGGGGGGGGGGGGGGGGGGGGGGGGGGGGGGGGGGGGGGGGGGGTTGTTTTGGTTTTTTTTTTTTGGGGGGGGGGGGGGGGGGGGGGGGGGGGTTTTTTTGGGGGGTTTTTOOOOOOOOOOOOOOOO
OOOOOOOOOOOOOOOOGTTTTTTGGTTTTGGWWWGTGGGGGGGGGGGGGGGGGGGGGGGGGGGGGGGGGGGGGGGGGTTTTTTTTGGGGTTTTTGTTTTTGGGGGGGGGGGGGGGGGGGGGGGGGGTTTTTTTTGGGGGTTTTTTOOOOOOOOOOOOOOOO
OOOOOOOOOOOOOOOOGTTTTTTTTTTTTTGGWWGTTTGGGGGGGGGGGGGGGGGGGGGGGGGGGGGGGGGGGGGGGTTTTTTTTGGGGGTGTTTGTGTTGGGGGGGGGGGGGGGGGGGGGGGGGGTTTTTTTTGGGGGGTTTTTOOOOOOOOOOOOOOOO
OOOOOOOOOOOOOOOTTTTGGGTTTTTTTTTGWWTTTTTGGGGGGGGGGGGGGGGGGGGGGGGGGGGGGGGGGGGGGTGTTTTTGGGGGGGGGTTTTTTTGGGGGGGGGGGGGGGGGGGGGGGGGGTTTTTTGGGGGGGGGTTTTOOOOOOOOOOOOOOOO
OOOOOOOOOOOOOOOTTGGGTGGGTTTTTTTGGWGTTTGGGGGGGGGGGGGGGGGGGGGGGGGGGGGGGGGGGGGGGTTGTTTGGGGGGGGGGTTTTTTGGGGGGGGGGGGGGGGGGGGGGGGGGGTTTTTGGGGGGGGGTTTTTOOOOOOOOOOOOOOOO
OOOOOOOOOOOOOOOTGGGGTGGTTTTTTTGGGGTTTGGGGGGGGGGGGGGTTGGTTTTTGGGGGGGGGGGGGGGGGTTTTTTGGGGGGGGGTTTTGTTGGGGGGGGGGGGGGGGGGGGGGGGGGGGGTTTGGGGGGGGGGTTTTOOOOOOOOOOOOOOOO
OOOOOOOOOOOOOOOOGGTTTGGTTTGGGTTTGGGTGGGGGGGGGGGGGGGTTTGTTTTTTTGGGGGGGGGGGGGGGTTTTTGGGGGGGGGGTTTTTTTGGGGGGGGGGGGGGGGGGGGGGGGGGGGGGGGGGGGGGGGGTTTGOOOOOOOOOOOOOOOOO
OOOOOOOOOOOOOOOOGGTTGGTTTGGGGGTTGGGGGGGGGGGGGGGGGGTTTTTTTGTTGTGGGGGGGGGGGGGGGGTTGTGGGGGGGGGGTTGTTTGGGGGGGGGGGGGGGGGGGGGGGGGGGGGGGGGGGGGGGGGGTTTGOOOOOOOOOOOOOOOOO
OOOOOOOOOOOOOOTTTTTTGGTTGGGGGGGGGGGGGGGGGGGGGGGGGGTTGTTTTGTTTTTTGGTTGGGGGGGGGGTTTTTGGGGGGGGGGTTTTGGGGGGGGGGGGGGGGGGGGGGGGGGGGGGGGGGGGGGGGGGTTTTGOOOOOOOOOOOOOOOOO
OOOOOOOOOOOOOOOTTTTGGTGGGGGGGGGGGGGGGGGGGGGGGGGGGGTTTTTTTTTTTTTGTTTTTGGGGGGGGGTTTTGGGGGGGGGGTTTTTGGGGGGGGGGGGGGGGGGGGGGGGGGGGGGGGGGGGGGGGGGGTTTTOOOOOOOOOOOOOOOOO
OOOOOOOOOOOOOOTTTTTGTGGGGGGGGGGGGGGGGGGGGGGGGGGGGGGTTTTGTTTGTGTTTTTTTTGGGGGGGGTTGTGGGGGGGGGTTTTTTGGGGGGGTTTGGGGGGGGGGGGGGGGGGGGGGGGGGGGGGGGGGTTTOOOOOOOOOOOOOOOOO
OOOOOOOOOOOOOOTTTTGGTGGGGGGGGGGGGGGGGGGGGGGGGGGGGGGTTTTTTTTTTTTTTTTTTGGGGGGGGTTGTTTGGGGGGGTTTTTTGGGGGGGTTTTTGGGGGGGGGGGGGGGGGGGGGGGGGGTGGGGGGGGGOOOOOOOOOOOOOOOOO
OOOOOOOOOOOOOOTTTTGTGGGGGGGGGGGGGGGGGGGGGGGGGGGGGGGGTTTGGGTTTTGTTTTTTTGGGGGGGTTTTGTGGGGGGTTGTTTGGGGGGGGGTTTTGGGGGGGGTTGGGGGGGGGGGGTTTTTTGGGGGGGGOOOOOOOOOOOOOOOOO
OOOOOOOOOOOOOOOTTTGGGGGGGGGGGGGGGGGGGGGGGGGGGGGGGGGGGGGGGGTGTGTTGTTGTTGGGGGGGTTGTTTGGGGGGGTTTTTGGGGGGGGTTGTTTGGGGGTTTTGGGGGGGGGGGGGTGGGGTTGGGGGGOOOOOOOOOOOOOOOOO
OOOOOOOOOOOOOOTTTTTGGGGGGGGGGGGGGGGGGGGGGGGGGGGGGGGGGGGGGGGTTTTTTTTGTTTGGGGGGTTTTTGGGGGGGGTTTTGGGGGGGGTTTTTTTTTTTTTTTTTGGGGGGGGGGGGTGGGGTGGGGGTTOOOOOOOOOOOOOOOOO
OOOOOOOOOOOOOOTTTTTTGGTTGTTGGGGGGGGGGGGGGGGGGGGGGGGGGGGGGGGTTGTTTTTGTTTGGGGGGGTTTGGGGGGGGGGGTTGGGGGGGTGTTTTTTTTTGTTTTTTGGGGGGGGGGGGGGGGGTTGGGGGTOOOOOOOOOOOOOOOOO
OOOOOOOOOOOOOOTTTTTTGGTTTTGGGGGGGGGGGGGGGGGGGGGGGGGGGGGGGGGTTTTTTTGTTTTGGGGGGGGGGGGGGGGGGGGGGGGGGGGGGTTGTTGTTTTTTTTTTTTTTGGGGGGGGGGGGGGTGGGGGGTTTOOOOOOOOOOOOOOOO
OOOOOOOOOOOOOOTTTTGTTGGGGGGGGGGGTTTGGGGGGGGGGGGGGGGGGGGGGGTGTTTTTTTTGTTTGGGGGGGGGGGGGGGGGGGGGGGGGGGGTTTTTTTTTTTTTTTTGTTTGGGGGGGGGGGGGGGGGGGGGGTTOOOOOOOOOOOOOOOOO
OOOOOOOOOOOOOOOOTTGTTGGTTGTTGGGTTTTTGGGGGGGGGGGGGGGGGGGGTTTTTTTGGGGTTTTGTGGGGGGGGGGGGGGGGGGGGGGGGGGGTTGTTTTTGGTTTTGTTTTTTGGGGGGGGGGGGGGGGGGGGGTGOOOOOOOOOOOOOOOOO
OOOOOOOOOOOOOOOOGGTTGTTTTTTTTTGGTTTTGGGGGGGGGGGGGGGGGGGTTTTGGTGGGGGGTTGTTGGGGGGGGGGGGGGGGGGGGGGGGGGGTTTTTTGGGGGGTTGTTTTTGGGGGGGGGGGGGGGGGGGGGGGGOOOOOOOOOOOOOOOOO
OOOOOOOOOOOOOOOTGGGGGTTTTGGTTGGTTTTGGGGGGGGGGGGGGGGGGGGTTGTTTTGGGGGGTTTTTGGGGGGGGGGGGGGGGGGGGGGGGGGGGTTTGGGGGGGGTTTTTTTTGGGGGGGGGGGGGGGGGGGGGGGGOOOOOOOOOOOOOOOOO
OOOOOOOOOOOOOOOTTTTTGGGGGGGGGGGTTTTGGGGGGGGGTTTGGGGGGGTGTTTTTGGGGGGGTTTTTGGGGGGGGGGGGGGGGGGGGGGGGGGGGGGGGGGGGGGGTTTTTTTGGGGGGGTTTTTTGGGGGGGGGGGGOOOOOOOOOOOOOOOOO
OOOOOOOOOOOOOOOTTTTTTTGGGGGTTTTTGGGGGGGGGGGTTTTTGGGGGGGTTTTTTTGGGGGGTGTTGGGGGGGGGGGGGGGGGGGGGGGGGGGGGGGGGGGGGGGGGTTTTTGGGGGGGTTTTTTTTTGGGGGGGGGGOOOOOOOOOOOOOOOOO
OOOOOOOOOOOOOOOTTTTTTTTGGGGGGTTTTGGGGGGGGGTTTTTTGGGGGGGTTTGTTGGGGGGGTTTTTGGGGGGGGGGGGGGGGGGGGGGGGGGGGGGGGGGGGGGGTTGTTGGGGGGGGTTTTTTTTTTTGGGGGGGGOOOOOOOOOOOOOOOOO
OOOOOOOOOOOOOOOTTGTTGTGGGGGGGTTTGGGGGGGGGTTTTTTTGGGGGGGGTTTGTTGGGGGGTTTGGGGGGGGGGGGGGGGGGGGGGGGGGGGGGGGGGGGGGGGGTTTTTGGGGGGGGTTTTTTTTTTTGGGGGTTGOOOOOOOOOOOOOOOOO
OOOOOOOOOOOOOOOTTTTTTGTGGGGGGGGGGGGGGGGGTTTTTTGGGGGGGGGGGTTTGGGGGGGGGGGGGGGGGGGGGGGGGGGGGGGGGGGGGGGGGGGGGGGGGGGTTTTTGGGGGGGGGGGGTTGTTTTTTGGGGGTTOOOOOOOOOOOOOOOOO
OOOOOOOOOOOOOOOTTTTTTTTGGGGGGGGGGGGGGGGGGGTTTTTGGGGGGGGGGGGGGGGGGGGGGGGGGGGGGGGGGGGGGGGGGGGGGGGGGGGGGGGGGGGGGTTTTGTGTGGGGGGGGGGGGGGGTTTTTGGGGGTTOOOOOOOOOOOOOOOOO
OOOOOOOOOOOOOOOTGGTTTTTTGGGGGGGGGGGGGGGGGGTTTTGGGGGGGGGGGGGGGGGGGGGGGGGGGGGGGGGGGGGGGGGGGGGGGGGGGGGGGGGGGGGGTTTGGTTTTGGGGGGGGGGGGGGGGGTTTGGGGGGGOOOOOOOOOOOOOOOOO
OOOOOOOOOOOOOOOTTTTGGTTTGGGGGGGGGGGGGGGGGTTTTTGGGGGGGGGGGGGGGGGGGGGGGGGGGGGGGGGGGGGGGGGGGGGGGGGGGGGGGGGGGGGGGTTTTTGTTGGGGGGGGGGGGGGGGTTTTGGGGGGGOOOOOOOOOOOOOOOOO
OOOOOOOOOOOOOTOTTTTTTTGTTTGGGGGGGGGGGGGGGTTTTTTTTTGGGGGGGGGGGGGGGGGGGGGGGGGGGGGGGGGGGGGGGGGGGGGGGGGGGGGGGGGGGTTTTTTTGGGGGGGGGGGGGGGGGGTTTGGGGGGGOOOOOOOOOOOOOOOOO
OOOOOOOOOOOOOTTTTGTGTGTTTTTTGGGGGGGGGGGTGTTTTGTGTTTGGGGGGGGGGGGGGGGGGGGGGTTTGGGGGGGGGTTTTTGGGGGGGGGGGGGGGGGGGGGTTTTGGGGGGGGGGGGGGGGGGTTTTGGGGGTGOOOOOOOOOOOOOOOOO
OOOOOOOOOOOOOOTTTTTTTTTTTTTTTTGGGGGGGGGGTTTTTTTGTTGGGGGGGGGGGGGGGGGGGGGGTTTTTGGGGGGGGTTTGTTGGGGGGGGGGGGGGGGGGGGGGGGGGGGGGGGGGGGGGGGGGGTTTGGGGGTTOOOTOOOOOOOOOOOOO
OOOOOOOOOOOOOOTTTGTTTTGTTGTTTGGGGGGGGGGTTTTTTTTTTTTGGGGGGGGGGGGGGGGGGGGTTTTTTGGGGGGGTTTTTTTGGGGGGGGGGGGGGGGGGGGGGGGGGGGGGGGGGTTGGGTGTTTTGGGGGGTTTTTOOOOOOOOOOOOOO
OOOOOOOOOOOOOTOTTGGGTTTTTTTTTGGGGGGGGGGGTGTTTTTTTTTGGGGGGGGGGGTTGGGGGGGTTTTTTTGGGGGGGTTTTTTTGGGGGGGGGGGGGGGGGGGGGGGGGGGGGGGGGTTTTTTTTTTTTGGGGGTTTTTTOOOOOOOOOOOOO
OOOOOOOOOOOOOOTTGGGGGGTTTTTTGGGGGGGGGGGGGGTTTTTTTTGGGGGGGGGGGGTTTGGGGGGTTTTTTGGGGGGGTTTTTGTTGGGGGGGGGGGGGGGGGGGGGGGGGGGGGGGGGGTTTTTTTTTTGGGGGTTTTTTOOOOOOOOOOOOOO
OOOOOOOOOOOOOTTTGGGGGGGGGTTGGGGGGGGGGGGGGGGTTGGTGGGGGGGGGGGGGGGTTGGGGGGTTTTTTTGGGGGGGTTTTTTTGGGGGGGGGGGGGGGGGGGGGGGGGGGGGGGGGGGTTTTTTTGGGGGGGGTTTTTTOOOOOOOOOOOOO
OOOOOOOOOOOOTOTTGGGGGGGGGGGGGGGGGGGGGGGGGGGGGGGGGGGGGGGGGGGTGGGTTTGGGGGTTTTTTTGGGGGGTGTTTTGGGGGGGGGGGGGGGGGGGGGGGGGGGTTTGGGGGGGGGGTTGGGGGGGGGTTTTTTOOOOOOOOOOOOOO
OOOOOOOOOOOOOOTTTGGGGGGGGGGGGGGGGGGGGGGGGGGGGGGGGGGGGGGGGGTTGGGTTGGGGGGGGTTTTTTGGGGGTTTTTGGGGGGGGGGGGGGGGGGGGTTTGGGGTTTTGGGGGGGGGGGGGGGGGGGGGGTTTTTOOOOOOOOOOOOOO
OOOOOOOOOOOOOOTTTGTGGGGGGGGGGGGGGGGGGGGGGGGGGGGGGGGGGGGGGGGTGTTGGGGGGGGGGGTTTTTTTGTTTTTTGGGGGGGGGGGGGGGGGGGGTTTTGGGGTTTTTGGGGGGGGGGGGGGGGGGGGGTTTTOOOOOOOOOOOOOOO
OOOOOOOOOOOOOOTTTTTTGGGGGGGGGGGGGGGGGGGGGGGGGGGGGGGGGGGGGGGGTTGGGGGGGGGGGGTTTTTTTTTTTTGTGGGGGGGGGGGGGGGGGGGGTTTTGGGGGTTGGSWGGGGGGGGGGGGGGGGGGTTTTTOOOOOOOOOOOOOOO
OOOOOOOOOOOOOOOTTTTTTGGGGGGGGGGGGGGGGGGGGGGGGGGGGGGGGGGGGGGGGGGGGGGGGTGGGGTGSSTTTTGTTTTTGGGGGGTTTTGGGGGGGGGTTTTTGGGGWWSSWWWWWGGGGGGGGGGGGGGGTTTTTTOOOOOOOOOOOOOOO
OOOOOOOOOOOOOOTTTTTTGGGGGGGGGGGGGGGGGGGGGGGGGGGGGGGGGGGGGGGGGGGGGGGGTTGGGGGWWWWSSSGTTGTTTGGGGGTTTTTGGGGGGGGTTTTTGWWWWWWWWWWWWGGGGGGGGGGGGGGGGGTTTTTOOOOOOOOOOOOOO
OOOOOOOOOOOOOOOTTTGGGGGGGGGGGGGGGGGGGGGGGTTTTGGGGGGGGGGGGGGGGGGGGGGGGSGTGWWWWWWWWWWSSTTTTTGGGTTTGTTGGGGGGGGTTGGWWWWWWWWWWWWWWWWGGGGGGGGGGGGGGGTTTTOOOOOOOOOOOOOOO
OOOOOOOOOOOOOOTTTTGGGGGGGGGGGGGGGGGGGGGGTTTTTTTGGGGGGGGGGGGGGGGGGGGSSWWWWWWWWWWWWWWWSGTTTTTTTTTTTTTTGGGGGGGGGWWWWWWWWWWWWWWWWWWWWWGGGGGGGGGGGTTTTTTOOOOOOOOOOOOOO
OOOOOOOOOOOOOOOTTTTGGGGGGGGGGGGGGGGGGGTTTTTGGTTGGGGGGGGGGGGGGGGGWWWWWWWWWWWWWSWWWWWWWSSTGSTTTTTTTGTGGGGGGGGSWWWWWWWWWWWWGGGGWWWWWWGGGGGGWSGTTTTTTTOOOOOOOOOOOOOOO
OOOOOOOOOOOOOOTTTTTGGGGGGGGGGGGGGGGGGGTTTGTTTGTTGGGGGGGGGGGGGGGGWWWWWWWWWWWWGGGSGWWWWWWWWSSSGGSTGTTGGGGGGGWSWWWWWWWWWGGGGTTGGGGWWWWGGGGGGWSSGTTTTTTOOOOOOOOOOOOOO
OOOOOOOOOOOOOOOTTTTTGGGGGGGGGGGGGGGGGGTTTGTTTTTGGGGGGGGGGGGGGGGGGWWWSGGSGGGGGGGGGGGWWWWWWWWSWWWWWTGGGGGGGGWWWWWWWWWWGGGGGTTTTTGGGWWGGGGGGWWSSSTTTTOOOOOOOOOOOOOOO
OOOOOOOOOOOOOOTTGTTTGGGGGGGGGGGGGGGGGTTTTTTTTTTGGGGGGGGGGGGGGGGGGGWWGGGGTGTTGGGGTTGGWWWWWWWWWWWWWGGGGGGGTGWWWWWWWGGGGGGGGTTTTTTTGGGGGGGGGWWWWSSGTTOOOOOOOOOOOOOOO
OOOOOOOOOOOOOOOTTTTTGGGGGGGGGGGGGGGGTTTTTTTTGGGGGGGGGGGGGGGGGGGGGGGGTGTTTTTTGGGGGTTGGWWWWWWWWWWWWWGGGGGGTGWWWWWGGGGGGGGGGGTTTTTTTTGGGGGGGGWWWWWWOOOOOOOOOOOOOOOOO
OOOOOOOOOOOOOOOTTTTTGGGGGGGGGGGGGGGTTTTTTTTGGGGGGGGGGGGGGGGGGGGGGGGGTTTTTTGGGGGGGGTTGGWGGGWWWWWWWGGGGGGTGSWWGGGTTGGGGGGGGTTGTTTTTTGGGGGGGGGGWWWWOOOOOOOOOOOOOOOOO
OOOOOOOOOOOOOOOOGTTTGGGGGGGGGGGGGTTTTTTTGTGGGGGGGGGGTTTTGGGGGGGGGGGGTTGGTTGGGGGGGGGTTGGGTGGGWWWWWGGGGGGGSWWWGTTTTTTGGGGGGTTTTTTTTTTGGGGGGTTGWWWWOOOOOOOOOOOOOOOOO
OOOOOOOOOOOOOOOOTTTTGGGGGGGGGGGGTTTTTTTTTGGGGGGGGGGGTTTTTGGWGGGGGGGGTTTTTTGGGGGGGGTTTTTTTTTGGWWWGGGGGGGGSWWSTTTTTTTGGGGGGTTTTTTGTTGGGGGGGGTGGWWWOOOOOOOOOOOOOOOOO
OOOOOOOOOOOOOOOOTGTTTGGGGGGGGGGGTTTTTTTTGGGGGGGGGGGGTTTTGWWWWWGGGGGGGTTTTTGGGGGGGGTTTTTTTTTTGGGGGGGGGGGGWWSGGTTTTTTTGGGGGGGGTTTTTTTGGGGGGGGGGWWWOOOOOOOOOOOOOOOOO
OOOOOOOOOOOOOOOOGGTTTTTGGGGGGGGTTTTTTTGTGGGGGGGGGGTTTTTGWWWWWWGGGGGGGGTTTGGGGGGGGTTTTTTGTTTTGGGGGGGGGGGGGWGTTTTGGTTGGGGGGGGGGTTTTTGGGGGGGGGGGGGWOOOOOOOOOOOOOOOOO
OOOOOOOOOOOOOOOOGTTTTTTTTGGGTTTTTTGTGTTGGGGGGGGGTTTTTTTGGWWWWSWGGGGGGGGGGGGGGGGGGTTTTGGGGTTTGGGGGGGGGGGGGGGTTTGGGGGGGGGGGGGGGGTTTTTGGGGGGGGGTTGWOOOOOOOOOOOOOOOOO
OOOOOOOOOOOOOOOOGGGTTTTTTTTTTTTTTTTTTTGGGGGGGGGGTTTGTTTTGWWWWGGGGGGGGGGGGGGGGGGGGTTTGGGGGGGGGGGGGGGGGGGGTTTTTGGGGGGGGGGGGGGGGGTGTTTGGGGGGGGTTGGGOOOOOOOOOOOOOOOOO
OOOOOOOOOOOOOOOOGGGGTTTTTTTTTGTTTTGWWTTGGGGGGGWWWTTTGSTGWWWWWGGGGGGGGGGGGGGGGGGGGGGGGGGGGGGGGGGGGGGGGGGGTTTTTTGGGGGGGGGGGGGGGGTTTTTGGGGGGTTTTTTTOOOOOOOOOOOOOOOOO
OOOOOOOOOOOOOOOOGGGGGTGTTTTTTGTGWWWWWWWGGGGGGGWWWWWWWWWWWSWWSGTGGGGGGGGGGGGGGGGGGGGGGGGGGGGGGGGGGGGGGGGTTTGTTTGGGGGGGGGGGGGGGGGTTTTGGGGGGGTTTTTTTTOOOOOOOOOOOOOOO
OOOOOOOOOOOOOOOOGGGGGTTTTTGTTTGWWWWWWWWGGGGGGGWWWWWWWWWWWWWSGTTTTGGGGGGGGGGGGGGGGGGGGGGGGGGGGGGGGGGGGGGGTTTTTGTGGGGGGGGGGGGGGGGGTTGGGGGGGGTTTTTTTTOOOOOOOOOOOOOOO
OOOOOOOOOOOOOOOOGGGGGGTTGTTTTGWWWWWWWWWGGGGGGGGWWWWWWGWWWWWSGTTTTTGGGGGGGGGGGGGGGGGGGGGGGGGGGGGGGGGGGGGGTTTGTTTGGGGGGGGGGGGGGGGGGGGGGGGGGGGTTTTTTTTOOOOOOOOOOOOOO
OOOOOOOOOOOOOOOOGGGSSTTTTTTTTGWWWWWWWGGGGGGGGGGGWWGGGGGWWGGGGGGTTTGGGGGGGGGGGGGGGGGGGGGGGGGGGGGGGGGGGGGGGTTTTTTTGGGGGGGGGGGGGGGGGGGGGGGGGGGTTTTTOOOOOOOOOOOOOOOOO
OOOOOOOOOOOOOOOOWWWWWWWGTGTGWWWWWWGGGGGGGGGGGGGGGGGGGGGGGGTGTGGGGTTTGGGGGGGGGGGGGGGGGGTGGGGGGGGGGGGGGGGGGTTTTGTGGGGGGGGGGGGGGGGGGGGGGGGGGGGGTTTGOOOOOOOOOOOOOOOOO
OOOOOOOOOOOOOOOOWWWWWWWWTGWWWWWGGGGGGGGGGGGGGGGGGGGGGGGGGGGTTGGGGTTGGGGGGGGGGGGGGGTGTTTTGGGGGGTGGGGGGGGGGGGTTTTGGGGGGGGGGGGGGGGGGGGGGGGGGGGTTTTGOOOOOOOOOOOOOOOOO
OOOOOOOOOOOOOOOOWWWWWWWWWWWWWWGGGGGGGGGGGGGGGGGGGGGGGGGGGGGGTGGGGTTTGGGGGGGGGGGGGTGTTTTTTGGGGGTTTGGGGGGGGGGGGGGGGGGGGGGGGGGGGGGGGGGGGGGGGGTTTTGGOOOOOOOOOOOOOOOOO
OOOOOOOOOOOOOOOOWWWWWWWWWWWWWWGGGGGGGGGGGGGGGGGGGGGGGGGGGGGGGGGGTTTGGGGGGGGGGGGTTTTTTTTTTTGGGGTTTTTGGGGGGGGGGGGGGGGGGGGGGGGGGGGGGGGGGGGGGGTTTTTGOOOOOOOOOOOOOOOOO
OOOOOOOOOOOOOOOOGGGGGGWWWWWWWGGGGGGGGGGGGGGGGGGGGGGGGGGGGGGGGGGGGTTGGGGGGGGGGGGTTTTTTTTTTTTGGTTTTTTTTTGGGGGGGGGGGGGGGGGGGGGGGGGGGTTTGGGGGGGTTTGTOOOOOOOOOOOOOOOOO
OOOOOOOOOOOOOOOOTTTTGGGGWWWGGGGGGGGGGGGGGGGGGGGGGGGGGGGGGGGGGGGGGGGGGGGGGGGGGGTTTTTGTTTTTTTGTTTTTTTTTTTGGGGGGGGGGGGGGGGGGGGGGGGGTTTTGGGGGGGTGTTTOOOOOOOOOOOOOOOOO
OOOOOOOOOOOOOOTOTTTTGGGGGGGGGGGGGGGGGGGGGGGGGGTTGTTGGGGGGGGGGGGGGGGGGGGGGGGGGGGTTTTTGGGGTTTTTTTTTTTTTTTTGGGGGGGGGGGGGGGGGGGGGGGGTTTTTGGGGGGGTTTTOOOOOOOOOOOOOOOOO
OOOOOOOOOOOOOOTTTTTTGGGGGGGGGGGGGGGGGGGGGGGGGTTTTTTTTGGGGGGGGGGGGGGGGGGGGGGGGTTTTGTGGGGGTTTTTTTTTGTTTTTTGGGGGGGGTTTGGGGGGGGGGGTTTTTTTGGGGGGGGGTTTOOOOOOOOOOOOOOOO
OOOOOOOOOOOOOOOTTTTGGGGGGGGGGGGGGGGGTTTGGGGGGTTTTTTTTTTTTGGGGGGGGGGGGGGGGGGGGGTTTTGGGGGGTTTTTTTGGGGGTTTTGGGGGGGGTTTTTTGGGGGGGGTTTTTTTGGGGGGGGGGTTTOOOOOOOOOOOOOOO
OOOOOOOOOOOOOOTTTTGGGGGGGGGGGGGGGGGGTTTTGGGGGTTTTTTTTTTTTTGGGGGGGGGGGGGGGGGGGGTTTGGGGGGGTTTTTTGGGGGGTTTTGGGGGGGGTTTTTTGGGGGGTTTTTTTTTGGGGGGGGGGTTTOOOOOOOOOOOOOOO
OOOOOOOOOOOOOOTTTTGGGGGGGGGGGGGGGGGTTTTTGGGGGTTTTTTTTTTTTTGGGGGGGGGGGGGGGGGGGGTTTTGGGGGGGTTTTTGGGGGGGTTTTGGGGGGGTTTTTTTTTTTTTTTTTTTTTGGGGGGGGGGGTTOOOOOOOOOOOOOOO
OOOOOOOOOOOOOOTOTTGGGGGGGGGGGGGGGGGTTTTTGGGGGGTTTTTGTTTTTTTGGGGGGGGGGGGGGGGGGGTTTGGGGGGGGTTTTTTGGGGGGTTTGGGGGGGGTTTTTTTTTTTTTTTTTTTGGGGGGGGGGGGGTTOOOOOOOOOOOOOOO
OOOOOOOOOOOOOOOTTTGGGGGGGGGGGGGGGGTTTTTGGGGGGGTTTGGGGGTTTTTTTGGGGGGGGGGGGGGGGGGTTGGGGGGGGTTTTTTGGGGGGTTTTGGGGGGGGGTTTTTTTTTTTTTTTTTGGGGGGGTGGGGTTTOOOOOOOOOOOOOOO
OOOOOOOOOOOOOOTOTGGGGGGGGTTGGGGGGGTTTTTTGGGGGGTTTGGGGGGGTTTTTGGGGGGGGGGGGGGGGGGGGGGGGGGGTTTTTTTGGGGGGTTTGGGGGGGGGGGGTTTTTTTTTTTTTTGGGGGGGGTTTTTTTTTOOOOOOOOOOOOOO
OOOOOOOOOOOOOOTTGGGGGGGGTTTGGGGGGTTTTTTGGGGGGTTTTGGGGGGGGGTTTTGGGGGGGGGGGGGGGGGGGGGGGGGGTTTTTTTTGGGGGGGGGGGGGGGGGGGGGTTTTTTTTTTTTTGGGGGGGGTTTTTTTTOOOOOOOOOOOOOOO
OOOOOOOOOOOOOOOTTGGGGGGGTTTTGGGGGGTTGGGTGGGGGTTTTGGGGGGGGGTTTGGGGGGGGGGGGGGGGGGGGGGGGGGTTTTTTTTTGGGGGGGGGGGGGGGGGGGGGGTTGTTTTTTTGGGGGGGGGGTTTTTTTTTOOOOOOOOOOOOOO
OOOOOOOOOOOOOOTTGTGGGGGTTTTGGGGGGGTGGGGTTTTTTTTTTGGGGGGGGGGGGGGGGGGGGGGGGGTTGGGGGGGGGGGGTTTTTTTTGGGGGGGGGGGGGGGGGGGGGGGGGGGGGGGGGGGGGGGGTTTTTTTTTTOOOOOOOOOOOOOOO
OOOOOOOOOOOOOOTTTGGGGGGGTTTGGGGGGGTGGGGGTTTTTTTTTTGGGGGGGGGGGGGGGGGGGGGGGGTTTTGGGGGGGGGGGTTGGTTGGGGGGGGGGGGGGGGGGGGGGGGGGGGGGGGGGGGGGGGGTTTTGTTTTTOOOOOOOOOOOOOOO
OOOOOOOOOOOOOOTTTTTGGGTTTTGGGGGGGGTGGGGGTTTTTTTTTTTTGGGGGGGGGGGGGGGGGGGGTTTTTTGGGGGGGGGGGGGGGGGGGGGGGGGGGGGGGGGGGGGGGGGGGGGGGGGGGGGGGGGTTTTGTGGGOOOOOOOOOOOOOOOOO
OOOOOOOOOOOOOOOOGGTTTTTTTTTGGGGGGGTTGGGGGTTTTTTTTTTTTGGGGGGGGGGGGGGGGGGGGTTTTTTTGGGGGGGGGGGGGGGGGGGGGGGGGGGGGTTTTGGGGGGGGGGGGGGGGGGGGGGTTTTTTTGWOOOOOOOOOOOOOOOOO
OOOOOOOOOOOOOOOOGGTTTTTTTTTGGGGGGGTTTGGTTTTTTTTTTTTTTGGGGGGGGGGGGGGGGGGGTTTTTTTTGGGGGGGGGGGGGGGGGGGGGGGGGGGGGTTTTTTTGGGGGGGGGGGGGGGGGGGGTTGWGGWWOOOOOOOOOOOOOOOOO
OOOOOOOOOOOOOOOOGGGTTTTTTTTGGGGGGGGGTTTTTTTGTTTTTTTTTTTGGGGGGGGGGGGGGGGGGGTTTTTTTTGGGGGGGGGGGGGGGGGGGGGGGGGGGTTTTTTTTGGGGGGGGGGGTTTTTGGGTGWWWWWWOOOOOOOOOOOOOOOOO
OOOOOOOOOOOOOOOOGTTTTTTTTTTGGGGGGGGGTTTTTTGGGGTTTTGGTTGGGGGGGGGGGGGGGGGGGGTTTTTTTTTTTGGGGGGGGGGGGGGGGGGGGGGGGGGTTTTTTTGGGGGGGGTTTTTTTGGGGWWWWWWWOOOOOOOOOOOOOOOOO
OOOOOOOOOOOOOOOOGTTTTTTTTTTGGGGGGGGGGGTTTGGGGGGGGGGGGGGGGGGGGGGGGGGGGGGGGGGGTTTTTTTTTTTTGGGGGGGGGGGGGGGGGGGGGGGGGTTTTGTGGGGGGGTTTTTTGSWWWWWWWWWWOOOOOOOOOOOOOOOOO
OOOOOOOOOOOOOOOTTTTTTTTTTTGGGGGGGGGGGGGGGGGGGGGGGGGGGGGGGGGGGGGGGTTGGGGGGGGGGGTTTTTTTTTTGGGGGGGGGGGGGGGGGGGGGGGGGGTTTTTTGGGGGGGSTTGWWWWWWWWWWWWWOOOOOOOOOOOOOOOOO
OOOOOOOOOOOOOOOTTGGGGTTTTTGGGGGGGGGGGGGGGGGGGGGGGGGGGGGGGGGGGGGGGTTTGGGGGGGGGGGTTTTTTTTTTGGTTTGGGGGGGGGGGGGGGGGGGGGTTTTGGGGGGGGWWWWWWWWWWWWWWWWWOOOOOOOOOOOOOOOOO
OOOOOOOOOOOOOOTTGGGGTTTTTTGGGGGGGGGGGGGGGGGGGGGGGGGGGGGGGGGGGGGGTTTTTGGGGGGGGGGGGGGTTTTTTTTTTTTGGGGGGGGGGGGGGGGGGGGTTTTTGGGGGGGWWWWWWWWGGWWGGWWWOOOOOOOOOOOOOOOOO
OOOOOOOOOOOOOOOTTGGGGTTTTTGGGGGGGGGGGGGGGGGGGGGGGGGGGGGGGGGGGGGGTTTTTGGGGGGGGGGGGGGGTTTTTTTTTTTGGGGGGGGGTTGGGGGGGGGTTTTGGGGGGGWWWWWWWWGGGGGTGGWWOOOOOOOOOOOOOOOOO
OOOOOOOOOOOOOOTTGGGGGGTTGGGGGGGGGGGGGGGGGGGGGGGGGGGGGTGGGGGGGGGTTTTTTGGGGGGGGGGGGGGGTTTTTTTTTGGGGGGGGGGGGTTTTGGGGGGTTGWGGGGGWSWWWWGGSGGTTTTTTGWWOOOOOOOOOOOOOOOOO
OOOOOOOOOOOOOOOTTGGGGGGGGGGGGGGGGGGGGGGGGGGGGGGGGGGGTGTTGGGGGGGTTTTTTTGGGGGGGGGGGGGGGGTTTTGGTGGGGGGGGGGGGTTTTTGGGGTTTGWGGGWWWWWWGGTGGTTTTTTTTGWWOOOOOOOOOOOOOOOOO
OOOOOOOOOOOOOOTTGGGGGGGGGGGGGGGGGGGGGGGGGGGGGGGGGGTTTGTTTGGGGGGTTTTTTGGGGGGGGGGGGGGGGGGTTGGGGGGGGGGGGGGGGTTTTTTTTTTGSWWWWWWWWWGGGTTTTTTTTTTTTGGWOOOOOOOOOOOOOOOOO
OOOOOOOOOOOOOOOTTTTGGGGGGGGGGGGGGGGGGGGGGGGGGGGGGGTTTTTTTTGGGGGTGTTTTTTGGGGGGGGGGGGGGGGGGGGGGGGGGGGGGGGGGGTTTTTTTGWWWWWWWWWWWGTTTTTTTTTTTTTTTTGSOOOOOOOOOOOOOOOOO
OOOOOOOOOOOOOOTTTTTGGGGGGGGGGGGGGGGGGGGGGGGGGGGGGTTTTTTTTGGGGGGTTTGTTTGGGGGGGGGGGGGGGGGGGGGGGGGGGGTTTGGGGGGTTTTTGWWWWWWWGGWGGGGTTGGGTTTTTTTTTTGGOOOOOOOOOOOOOOOOO
OOOOOOOOOOOOOOOTTTTTTGGGGGGGGGGGGGGGGGGGGGGGGGGGGGTTTTTTGGGGGGGGTTTTTTTGGGGGGGGGGGGGGGGGGGGGGGGGGGTTTTGGGGGGGGGGGWWWWWWGTGGTTGGGGGGTTGGTTTTTTTTTTOOOOOOOOOOOOOOOO
OOOOOOOOOOOOOOOTTTTTTGGGGGGGGGGGGGGGGGGGGGGGGGGGGGTGGTTGGGGGGGGGTTTTTGGGGGGGGGGGGGGGGGGGGGGGGGGGGGGTTGGGGGGGGGGGGGWWSGGGTTTTGGGGGGGGGGGGTTTTTTTTTOOOOOOOOOOOOOOOO
OOOOOOOOOOOOOOOOTTTTTTTGGGGGGGGGGGGGGGGGGGGGGGGGGGGTTTTTTGGGGGGTTTGTTTGGGGGGGGGGGGGGGGGGGGGGGGGGGGGGGGGGGGGGGGGGGGGGGTTTTTTGGGGGGGGGGGGGGGTTTTTTTTOOOOOOOOOOOOOOO
OOOOOOOOOOOOOOOTTTTTTTGGGGGGGGGGGGGGGGGGGGGGGGGGGGGTTTTTGGGGGGGGTTTTTGTGGGGGGGGGGGGGGGGGGGGGGGGGGGGGGGGGGGGGGGGGGGGGGGTTTTGGGGGGGGGGGTTGGGTTTGGGOOTOOOOOOOOOOOOOO
OOOOOOOOOOOOOOOOGGTTTTTGGGGGGGGGGGGGGGGGGTTTGGGGGGGTTTTTGGGGGGGGTTTTTTTTTGGGGGGGGGGGGGGGGGGGGGGGGGGGGGGGGGGGGGGGGGGGGGTTGGGGGGGGGGGGGGGTGGTTGGGGOOTOOOOOOOOOOOOOO
OOOOOOOOOOOOOOOOGGTTTTGGGGGGGGGGGGGGGGGTTTTTTGGGGGGTTTTTGTGGGTGTTGTTTTTTTGGGGGGGGGGTTGGGGGGGGGGGGGGGGGGGGSGGGGGGGGGGGGGGGGGGGGGGGGGGGGGGGTTGGGTGOOOOOOOOOOOOOOOOO
OOOOOOOOOOOOOOOOGGGTTTTGGGGGGGGGGGGTTGGTTTTTTTTGGGGGGTGTTTGGGGGTTTTTTTTTTGGGGGGGGGTTTTGTGGGGGGGGGGGGGGGGGSSSGGGGGGGGGGGGGGGGGGGGGGGGGGGGGTTGTTGGOOOOOOOOOOOOOOOOO
OOOOOOOOOOOOOOOOGGTTTTTGGGGGGGGGGGTGTTTTTTTTTTTGGGGGGTTTTTTTTTTTGGTTTTTTGGGGGGGGGTTTTTTTGGGGGTTGGGGGGGGGGGGSSWGGGGGGGGGGGGGGGGGGGGGGGTGGGTTGGGGGOOOOOOOOOOOOOOOOO
OOOOOOOOOOOOOOOOGGGGTTTTGGGGGGGGGTTTGTTTTTTTTTTGGGGGGTTTTTTTTTTTGTTTTTTTGGGGGGGGGTTTTTTTTGGGGTTTGGGGGGGGGGGSSWWWGGGGGGGGGGGGGGGGGGGGGGGGGTTGGGGGOOOOOOOOOOOOOOOOO
OOOOOOOOOOOOOOOOGGGTTTTGGGGGGGGGTTTTTTTTTTTTTTTGGGGGGTTTTTTTTTGGTTTTTTTTTGGGGGGGTTTTTTTTGGGGTTTTTGGGGGGGTTGGSWWWGGGTTGGGGGTTGGGGGGGGGGGGGTTGGGGGOOOOOOOOOOOOOOOOO
OOOOOOOOOOOOOOOOGGGGTTTTGGGGGGGGTTTTTTTTTTTTTTTTGGGGGTTTTTTTTGGGGGTTTTTTTTTGGGTTTTTTGGGTTGGGGTTTTTTGGGGGGTGGSWWWWTTTTGGGTTTTGGGGGGGGGGGGGTTTGGGGOOOOOOOOOOOOOOOOO
OOOOOOOOOOOOOOOOGGGTTTTTTTGGGGGTTTTTTTTTTTGGTTTTGGGTTTGTGTTGGGTTGGGTTTTTTTTTTTTTTTTGGGGTTGGGGTTTTTGGGGGGGTGGSWWWWGTTTTTTTTTTTTTTGGGGGGTTTTTTTGGGOOOOOOOOOOOOOOOOO
OOOOOOOOOOOOOOOOGGGGGTTTTTTTTTTTTTTTTGGGTGGGGGGTTTTTTTTGTTGGGGGGTGGGGTTTTTTTTTTTTTGGGTGGGTTGGTTTTTTTGGGGGTTGSWWWWSTTTTTTTTTTTTTTGGGGGGTTTTTTGGGTOOOOOOOOOOOOOOOOO
OOOOOOOOOOOOOOOOGGGGTTTTTTTTTTTTTTGGGGGGGGTTGGGTTTTTTGGTGGGGTTGGGGGGTTTTTTTTTTTTTTGTTTTGGTTTTGGGGTTTGGTTTTGWWSSWWSGWGTTTTTTTTTTTTGGGGGGGGTTGGGGGOOOOOOOOOOOOOOOOO
OOOOOOOOOOOOOOOOOOOOOTTTTTTTTTTTTOOOTOOOOOOOTOOOTTOOOOOOOOOOOOOOOOOOOTTTTTTTTTTTTTOOTTTOOOTTOOOOOOOOTTTTTOOOOOOOOOOOTTTTTTTTTTTTTOOOTTOOOOOOTTTOOOOOOOOOOOOOOOOOO
OOOOOOOOOOOOOOOOOOOOTTTTTTTTTTTTTOOTOOOOOOOOOTOOTOOOOOOOOOOOOOOOOOTOOTTTTTTTTTTTTOOTTTOOTTOOOOOOOOOOTOOOOOOOOOOOOOOOOTTTTTTTTTTOOOOOOOOOOTOOOOOOOOOOOOOOOOOOOOOOO
OOOOOOOOOOOOOOOOOOOOTTTTTTTTTTTTTTOOOOOOOOOOOOOOOOOOOOOOOOOOOOOOOOOTOOOTTTTTTTTTOOOTTTOOOOOOOOOOOOOOOTOOOOOOOOOOOOOOOTTTTTTTTOOOOOOOOOOOTTTOOOOOTOOOOOOOOOOOOOOOO
OOOOOOOOOOOOOOOOOOOOOOOOOOOOOOOOOOOOOOOOOOOOOOOOOOOOOOOOOOOOOOOOOOOOOOOOOOOOOOOOOOOOOOOOOOOOOOOOOOOOOOOOOOOOOOOOOOOOOOOOOOOOOOOOOOOOOOOOOOOOOOOOOOOOOOOOOOOOOOOOO
OOOOOOOOOOOOOOOOOOOOOOOOOOOOOOOOOOOOOOOOOOOOOOOOOOOOOOOOOOOOOOOOOOOOOOOOOOOOOOOOOOOOOOOOOOOOOOOOOOOOOOOOOOOOOOOOOOOOOOOOOOOOOOOOOOOOOOOOOOOOOOOOOOOOOOOOOOOOOOOOO
OOOOOOOOOOOOOOOOOOOOOOOOOOOOOOOOOOOOOOOOOOOOOOOOOOOOOOOOOOOOOOOOOOOOOOOOOOOOOOOOOOOOOOOOOOOOOOOOOOOOOOOOOOOOOOOOOOOOOOOOOOOOOOOOOOOOOOOOOOOOOOOOOOOOOOOOOOOOOOOOO
OOOOOOOOOOOOOOOOOOOOOOOOOOOOOOOOOOOOOOOOOOOOOOOOOOOOOOOOOOOOOOOOOOOOOOOOOOOOOOOOOOOOOOOOOOOOOOOOOOOOOOOOOOOOOOOOOOOOOOOOOOOOOOOOOOOOOOOOOOOOOOOOOOOOOOOOOOOOOOOOO
OOOOOOOOOOOOOOOOOOOOOOOOOOOOOOOOOOOOOOOOOOOOOOOOOOOOOOOOOOOOOOOOOOOOOOOOOOOOOOOOOOOOOOOOOOOOOOOOOOOOOOOOOOOOOOOOOOOOOOOOOOOOOOOOOOOOOOOOOOOOOOOOOOOOOOOOOOOOOOOOO
OOOOOOOOOOOOOOOOOOOOOOOOOOOOOOOOOOOOOOOOOOOOOOOOOOOOOOOOOOOOOOOOOOOOOOOOOOOOOOOOOOOOOOOOOOOOOOOOOOOOOOOOOOOOOOOOOOOOOOOOOOOOOOOOOOOOOOOOOOOOOOOOOOOOOOOOOOOOOOOOO
OOOOOOOOOOOOOOOOOOOOOOOOOOOOOOOOOOOOOOOOOOOOOOOOOOOOOOOOOOOOOOOOOOOOOOOOOOOOOOOOOOOOOOOOOOOOOOOOOOOOOOOOOOOOOOOOOOOOOOOOOOOOOOOOOOOOOOOOOOOOOOOOOOOOOOOOOOOOOOOOO
OOOOOOOOOOOOOOOOOOOOOOOOOOOOOOOOOOOOOOOOOOOOOOOOOOOOOOOOOOOOOOOOOOOOOOOOOOOOOOOOOOOOOOOOOOOOOOOOOOOOOOOOOOOOOOOOOOOOOOOOOOOOOOOOOOOOOOOOOOOOOOOOOOOOOOOOOOOOOOOOO
OOOOOOOOOOOOOOOOOOOOOOOOOOOOOOOOOOOOOOOOOOOOOOOOOOOOOOOOOOOOOOOOOOOOOOOOOOOOOOOOOOOOOOOOOOOOOOOOOOOOOOOOOOOOOOOOOOOOOOOOOOOOOOOOOOOOOOOOOOOOOOOOOOOOOOOOOOOOOOOOO
OOOOOOOOOOOOOOOOOOOOOOOOOOOOOOOOOOOOOOOOOOOOOOOOOOOOOOOOOOOOOOOOOOOOOOOOOOOOOOOOOOOOOOOOOOOOOOOOOOOOOOOOOOOOOOOOOOOOOOOOOOOOOOOOOOOOOOOOOOOOOOOOOOOOOOOOOOOOOOOOO
OOOOOOOOOOOOOOOOOOOOOOOOOOOOOOOOOOOOOOOOOOOOOOOOOOOOOOOOOOOOOOOOOOOOOOOOOOOOOOOOOOOOOOOOOOOOOOOOOOOOOOOOOOOOOOOOOOOOOOOOOOOOOOOOOOOOOOOOOOOOOOOOOOOOOOOOOOOOOOOOO
OOOOOOOOOOOOOOOOOOOOOOOOOOOOOOOOOOOOOOOOOOOOOOOOOOOOOOOOOOOOOOOOOOOOOOOOOOOOOOOOOOOOOOOOOOOOOOOOOOOOOOOOOOOOOOOOOOOOOOOOOOOOOOOOOOOOOOOOOOOOOOOOOOOOOOOOOOOOOOOOO
OOOOOOOOOOOOOOOOOOOOOOOOOOOOOOOOOOOOOOOOOOOOOOOOOOOOOOOOOOOOOOOOOOOOOOOOOOOOOOOOOOOOOOOOOOOOOOOOOOOOOOOOOOOOOOOOOOOOOOOOOOOOOOOOOOOOOOOOOOOOOOOOOOOOOOOOOOOOOOOOO
