type octile-corner
height 161
width 161
map
OOOOOOOOOOOOOOOOOOOOOOOOOOOOOOOOOOOOOOOOOOOOOOOOOOOOOOOOOOOOOOOOOOOOOOOOOOOOOOOOOOOOOOOOOOOOOOOOOOOOOOOOOOOOOOOOOOOOOOOOOOOOOOOOOOOOOOOOOOOOOOOOOOOOOOOOOOOOOOOOO
OOOOOOOOOOOOOOOOOOOOOOOOOOOOOOOOOOOOOOOOOOOOOOOOOOOOOOOOOOOOOOOOOOOOOOOOOOOOOOOOOOOOOOOOOOOOOOOOOOOOOOOOOOOOOOOOOOOOOOOOOOOOOOOOOOOOOOOOOOOOOOOOOOOOOOOOOOOOOOOOO
OOOOOOOOOOOOOOOOOOOOOOOOOOOOOOOOOOOOOOOOOOOOOOOOOOOOOOOOOOOOOOOOOOOOOOOOOOOOOOOOOOOOOOOOOOOOOOOOOOOOOOOOOOOOOOOOOOOOOOOOOOOOOOOOOOOOOOOOOOOOOOOOOOOOOOOOOOOOOOOOO
OOOOOOOOOOOOOOOOOOOOOOOOOOOOOOOOOOOOOOOOOOOOOOOOOOOOOOOOOOOOOOOOOOOOOOOOOOOOOOOOOOOOOOOOOOOOOOOOOOOOOOOOOOOOOOOOOOOOOOOOOOOOOOOOOOOOOOOOOOOOOOOOOOOOOOOOOOOOOOOOO
OOOOOOOOOOOOOOOOOOOOOOOOOOOOOOOOOOOOOOOOOOOOOOOOOOOOOOOOOOOOOOOOOOOOOOOOOOOOOOOOOOOOOOOOOOOOOOOOOOOOOOOOOOOOOOOOOOOOOOOOOOOOOOOOOOOOOOOOOOOOOOOOOOOOOOOOOOOOOOOOO
OOOOOOOOOOOOOOOOOOOOOOOOOOOOOOOOOOOOOOOOOOOOOOOOOOOOOOOOOOOOOOOOOOOOOOOOOOOOOOOOOOOOOOOOOOOOOOOOOOOOOOOOOOOOOOOOOOOOOOOOOOOOOOOOOOOOOOOOOOOOOOOOOOOOOOOOOOOOOOOOO
OOOOOOOOOOOOOOOOOOOOOOOOOOOOOOOOOOOOOOOOOOOOOOOOOOOOOOOOOOOOOOOOOOOOOOOOOOOOOOOOOOOOOOOOOOOOOOOOOOOOOOOOOOOOOOOOOOOOOOOOOOOOOOOOOOOOOOOOOOOOOOOOOOOOOOOOOOOOOOOOO
OOOOOOOOOOOOOOOOOOOOOOOOOOOOOOOOOOOOOOOOOOOOOOOOOOOOOOOOOOOOOOOOOOOOOOOOOOOOOOOOOOOOOOOOOOOOOOOOOOOOOOOOOOOOOOOOOOOOOOOOOOOOOOOOOOOOOOOOOOOOOOOOOOOOOOOOOOOOOOOOO
OOOOOOOOOOOOOOOOOOOOOOOOOOOOOOOOOOOOOOOOOOOOOOOOOOOOOOOOOOOOOOOOOOOOOOOOOOOOOOOOOOOOOOOOOOOOOOOOOOOOOOOOOOOOOOOOOOOOOOOOOOOOOOOOOOOOOOOOOOOOOOOOOOOOOOOOOOOOOOOOO
OOOOOOOOOOOOOOOOOOOOOOOOOOOOOOOOOOOOOOOOOOOOOOOOOOOOOOOOOOOOOOOOOOOOOOOOOOOOOOOOOOOOOOOOOOOOOOOOOOOOOOOOOOOOOOOOOOOOOOOOOOOOOOOOOOOOOOOOOOOOOOOOOOOOOOOOOOOOOOOOO
OOOOOOOOOOOOOOOOOOOOOOOOOOOOOOOOOOOOOOOOOOOOOOOOOOOOOOOOOOOOOOOOOOOOOOOOOOOOOOOOOOOOOOOOOOOOOOOOOOOOOOOOOOOOOOOOOOOOOOOOOOOOOOOOOOOOOOOOOOOOOOOOOOOOOOOOOOOOOOOOO
OOOOOOOOOOOOOOOOOOOOOOOOOOOOOOOOOOOOOOOOOOOOOOOOOOOOOOOOOOOOOOOOOOOOOOOOOOOOOOOOOOOOOOOOOOOOOOOOOOOOOOOOOOOOOOOOOOOOOOOOOOOOOOOOOOOOOOOOOOOOOOOOOOOOOOOOOOOOOOOOO
OOOOOOOOOOOOOOOOOOOOOOOOOOOOOOOOOOOOOOOOOOOOOOOOOOOOOOOOOOOOOTOOOOOOOOOOOOOOOOOOOOOOOOOOOOOOOOOOOOOOOOOOOOOOOOOOOOOOOOOOOOOOOOOOOOOOOOOOOOOOOOOOOOOOOOOOOOOOOOOOO
OOOOOOOOOOOOOOOOOOOOOOOOOOOOOOOOOOOOOOOOOOOOOOOOOOOOOOOOOOOOTTTTTTOTOOOOOOOOOOOOOOOTOOTOOOOOOOOOOOOOOOOOOOOOOOOOOOOOOOOOOOOOOOOOOOOOOOOOOOOOOOOOOOOOOOOOOOOOOOOOO
OOOOOOOOOOOOOOOOOOOOOOOOOOOOOOOOOOOOOOOOOOOOOOOOOOOOOOOOOOOOOTOTTTOOTTTTOOOOOOOOOOOOTTTTOOOOOOOOOOOOOOOOOOOOOOOOOOOOOOOOOOOOOOOOOOOOOOOOOOOOOOOOOOOOOOOOOOOOOOOOO
OOOOOOOOOOOOOOOOOOOOOOOOOOOOOOOOOOOOOOOOOOOOOOOOOOOOOOOOOOOOTOOOOOOOOOOOOOOOOOOOOOOOOOOOOOOOOOOOOOOOOOOOTOOOOOOOOOOOOOOOOOOOOOOOOOOOOOOOOOOOOOOOOOOOOOOOOOOOOOOOO
OOOOOOOOOOOOOOOOOOOOOOOOOOOOOOOOOOOOOOOOOOOOOOOOOOOOOOOOOOOOOOOTTTOOOOOOOOTTTOOOOOOOOOOOOOOOOOOOOOOOOOOTTTOOOOOTOOOOOOOOOOOOOOTOOOOOOOOOOOOOOOOOOOOOOOOOOOOOOOOOO
OOOOOOOOOOOOOOOWWWWWWWWWWWWWWWWWWWWWWWWWWWWWWWWWWWWWWWGGGGTTGGTTTTGGGGGTGGGTTTGGGGGGWWWWWWGWWGGGWWWGTGGTTTGGGGGGGGWWGGGWTGTGGTGWWWWWGWGGGWWWWWWWWOOOOOOOOOOOOOOOO
OOOOOOOOOOOOOOOWWWWWWWWWWWWWWWWWWWWWWWWWGWWWWWWWWWWGWGGTTTGGGTGTGTTTTTTTGGGTTTTTTGWGGWWWGGGGGTGWWWWTTGGTTTGGGGGGGGGGGTGGGGGGGTGGWGGGGGWTGWGWWWWWWOOOOOOOOOOOOOOOO
OOOOOOOOOOOOOOOWWWWWWWWWWWWWWWWWWWWWWWGGGGWWWGGWWWWGGGTTTGGGTTTTTTTTTTTTTTGTTTTTGWWWWWWWTTGTGWGWWWWGTGGTTGGTTTTGGGGGGGGGGGTGGGTGGGTTGWWTGGGGWWWWWOOOOOOOOOOOOOOOO
OOOOOOOOOOOOOOOWWWWWWWWWWWWWWWWWWWWWWGTTTGGWGGGGWWGGTGTGGGGGTGTTTTTTTTTTTTGGGGTTGGWWWWWWWTGWWWWWWWWTTGGGGGGGTTTTTTTTTTTTTTTTTGGGGGGGGWGTTGWWWWWWWOOOOOOOOOOOOOOOO
OOOOOOOOOOOOOOOWWWWWWWWWWWWWWWWWWWWWGTTGGTGGGTGGGGTTTTTTTGTTTTTTTTTTTTTTTTTTGGGTTGGGWGWWWGWWWWWWWWGGTGGGGGTTTTTTTTTTGTTTTTTTTTGGGTGGGWGWGGWWWWWWWOOOOOOOOOOOOOOOO
OOOOOOOOOOOOOOOWWWWWWWWWWWWWWWWWWWWWGTTTTTTTTTTTTGGGGGGGGGGTTTTTTTTTTTTTTTTTTGGGTTTGGGWWWWWWWWWWWWWGTGGGTTTTTTTTTTTGGGGGTTTTTTGGTTTGGWWWWWWWWWWWWOOOOOOOOOOOOOOOO
OOOOOOOOOOOOOOOWWWWWWWWWWWWWWWWWWWWWWWGWWGTTTTTTTGGTTTGGTTTTTTTTTTTGTTTTTTTTTTTGGGTTTGGWWGGWWWGWGWGGGGTTTTTTTTTTTTGGGGGTTTTTTGGGGTGGGGGGGWWWWWWWWOOOOOOOOOOOOOOOO
OOOOOOOOOOOOOOOWWWWWWWWWWWWWWWWWWWWWWWWWWWTTTTTTTGTGTTTTTTTTTTTTTTGGGGGTTTTTTTTTGGTTGTGGGTGGGGGGGGTTGGTTTTTTTTTTTTGGGGGGGTTTTTTGGGGGGGGTGGWWWWWWWOOOOOOOOOOOOOOOO
OOOOOOOOOOOOOOOWWWWWWWWWWWWWWWWWWWWWWWWWWGTTTTTTGGGTTTTTTTGGGTTTTGGGGGGTTGGTTTTTTGGTGTTTTTTTTGTTTTTTGGTTTTTGTTGTTTGGGGGGGTTTTTTGGTGGTTGGTGWWWWWWWOOOOOOOOOOOOOOOO
OOOOOOOOOOOOOOOWWWWWWWWWWWWWWWWWWWWGGGWGGTGTTGGGGGGTTTTTTTGGGTTTGGGGGGGGGGGGTTTTTGTTTTTTTTTTTTGTTTTTGTTTTGGGGGGTTTGGGGGGGGTTTTTTGGGTTTTGTGWWWWWWWOOOOOOOOOOOOOOOO
OOOOOOOOOOOOOOOWWWWWWWWWWWWWWWWWWWWGTGGGGTGGTGGGGGGGGTTGTTGGGTGGGGGGGGGGGGGGGTTTTGTTTTTTTTTGTTTTGTTGGGTTTTGGGGGGGGGGGGGGGGGGGTTTTGGGTTTGTGGWWWWWWOOOOOOOOOOOOOOOO
OOOOOOOOOOOOOOOWWWWWWWWWWWWWWWWWWWWWTTTGGGGGGGTTTGGGGGTTTTGGGGGGGGGGGGGGGGGGTTTTTGGTTTTGTGWGWWWTTGGGTTTTGGGGGGGGGGGGGGGGGGGGGTTTTGGGGTGGTTGWGGGWWOOOOOOOOOOOOOOOO
OOOOOOOOOOOOOOOWWWWWWWWWWWGWWWWWWWWWWTTGGGGTTTTTTTGGTTTTTGGGGGGGGGGGGGGGGGGGTTTTGGTTTTTGGWWWWWWTTGGGTTTTGGGGGGGGGGGGGGGGGGGGGTTTTGTGGGTGGGGGTGGGGOOOOOOOOOOOOOOOO
OOOOOOOOOOOOOOOWWWWWWWGGGGGGWWWWWWWWWTTGTTTTTTTTTGGGTTTTTTGGGGGGGGGGGGGGGGGGGTTTGTTTTGGTGWWWWWGTGGTTTTTGGGGGGGGGGGGGGGGGGGGGGGGTTGGTGTTTGGGGGTTGWOOOOOOOOOOOOOOOO
OOOOOOOOOOOOOOOWWWWWWGTTTTTGWWWWWWWWGTTGGTGTTTTTTGGGTTTTTTGGGGGGGGGGGGGGGGGGTTTGGGTTGTGTGGWGGGTGGGTTTTGGGGGGGGGGGGGGGGGGGGGGGGTTTGGTGGTGTTTGGGGGWOOOOOOOOOOOOOOOO
OOOOOOOOOOOOOOOWWWWGGGTTGTGWWWWWWWWWGGGGGGGGTTTTGGGGGTTTTTTGGGGGGGGGGGGGGGGTTGGGGTTGTTGGTGGGGGGGGTTTGGGGGGGGGGGGGGGGGGGGGGGGGTTTTTGTGGGTTTTTGGGWWOOOOOOOOOOOOOOOO
OOOOOOOOOOOOOOOWWGGGTGTTTTGGWWGGWWWGGGGGTTGGTTTTGTTGGGTTTTGGGGGGGGGGGGGGGTTTTGGGGGTTTTTGTGGGTTTGGTTTTTGGGGGGGGGGGGGGGGGGGGGGTTTTTTGGGGGTTTGTTGGWWOOOOOOOOOOOOOOOO
OOOOOOOOOOOOOOOWWGTTGTTTGTGGGGGGGGGGGTTGGGTGGGTGGTTTGGGGTTTTGGGGGGGGGGGGGTTTTTTGGGGTGTTGGGGTTTTGGTTTTGGGGGGGGGGGGGGGGGGGGGGGTTTTTTTGTGTGTTTGTGGGGOOOOOOOOOOOOOOOO
OOOOOOOOOOOOOOOWWWGTTTTGTTTTTTTTTTTGTGTGGGSSSGGGTTGGGTGGTTTGGGGGGGGGGGGGTTTTTTTTGGGTGGGGGTGGGTGTGGTTTGGGGGGGGGGGGGGGGGGGGGGGTTTTTTTGGGTTTGTTTGGGGOOOOOOOOOOOOOOOO
OOOOOOOOOOOOOOOWWWTTTTGTTTTTTTTTTTTGGGGGGSSSGGGTTGGTTGTGGGGGGGGGGGGGGGGGGTTTTTTTTGGTTTGGTGGGGGGGGGTTGGGGGGGGTTGGGGGGGGGGGGGGGTTTTTGGGGGTGGTTGGGGTOOOOOOOOOOOOOOOO
OOOOOOOOOOOOOOOWWWTGTGGGGGGTTGTTTGTGGGGGGGSSSTTTTGGTTTGGGTGGGGTTGGGGGGGGGTTTTTTTTGGGTGGTGGGGGGGGGGGGGGGGGGGTTTTGGGGGGGTTTGGGGGTTGGGTGGTGGTTGGGGGWOOOOOOOOOOOOOOOO
OOOOOOOOOOOOOOOWWGTGGGGGGGGGGGGTTTTGTTTTTGSSGGTTGGTGGGGGGGTTTGTTTGGGGGGGGGGTTTTTTGGTTGGGTGGGGGGGGGGggggggGGTTTTTTGGGGTTTTGGGGGGGGTTGTGGTTTTGTGWWWOOOOOOOOOOOOOOOO
OOOOOOOOOOOOOOOWWWWTGGGTTTGGTTGGGTTGGGGGGGSSGGTGGGTTGGGGGGGTTGGTTGGGGGGGGGGGTTTGGGGTTGGGTGGGGGGGGGGggggggGTTTTTTGGGGTTTTTTGGGGGGGTTTGGTGTTGGTGWWWOOOOOOOOOOOOOOOO
OOOOOOOOOOOOOOOWWWWWGGTTTTTTTTTGGTGGGGGGGGGGGWTTGTTGGGGGGGGGGTGTGGGGGGGGGGGGGGGGGGGTGTGGGGGGGGGGGGGggggggGGTTGGGGTGTTTTTTTGGGGGGGTGGGGGTGGTGTGWWWOOOOOOOOOOOOOOOO
OOOOOOOOOOOOOOOWWWWGGTTTTTTTTTTTGGGTTTGGGGGGWWGTGGGTGGGGGGGGGTGTGGGGGGGGGGGGGGGGGTGGGGTGGGGGGGGGGGGGGGGGGGGGGGGGTTGGTTTTTTGGGGGGGGGGTGGGGGGGGGGWWOOOOOOOOOOOOOOOO
OOOOOOOOOOOOOOOWWGGGGGTTTTTTTTTTGGGTTTTTGGGGGWTTGGTTGGGGGGGGGTGGGGGGGGGGGGTTTGGGGTGGGGGGGGGGGGGGGGGGGGGGGGGGGGGGGGGGGGTTTGGGGGGGGTTGTGGGGGTTGWWWWOOOOOOOOOOOOOOOO
OOOOOOOOOOOOOOOWGGGGTTTTTTTGTTTTTGTTTTTTTTGTGGSGWGGTTGGGGGGGGTTTGGGGGGGGGGTTTGGGTTTTTGGGGGGGGGGGGGGGGGGGGGGGGGGGGGGGGGGGGGGGGTTTTTGGGGGGTGWWWWWWWOOOOOOOOOOOOOOOO
OOOOOOOOOOOOOOOWGGGTTTTTTGTGGGGGTTTTTTTTTTGGSSSSWGGTGGGGGGGGGGTTGGggggggGGTTTGGGGTTTGGTGGGGGGGGGGGGGGGGGGGGGGGGGGGGGGGTGGGGTTGTTTTTGGGGWWWWWWWWWWOOOOOOOOOOOOOOOO
OOOOOOOOOOOOOOOWGGTTTTGGGGGGGGTTTTTTTTTTTGGGGSSSGGGGGTTGGGGGGGGTTGggggggGGTTTGGGGTTGGTTGGGGGGGGGGGGGGGGGGGGGGGGGGGGGGTTTGGTGTTGTTGTGGGWWWWWWWWWWWOOOOOOOOOOOOOOOO
OOOOOOOOOOOOOOOWGGGTTGGGGGGGGGGTTTTTTTTTGGGGGGSWWWGGGTTTTGGGGGGGGGggggggGGGTGGGGTGGTGGGTGGGGGGGGGGGGGGGGGGGGGGGGGGGGGTTTGGGTTTGTTTTGTGWWWWWWWWWWWOOOOOOOOOOOOOOOO
OOOOOOOOOOOOOOOGWGGTTGGGGGGGGGGGTGTTTTTGGGGGGGGWWWGWGGGGTTGGGGGGGGGGGGGGGGGGGGGGGGGGGGTTTGGGGGGGGGGGGGGGGGGGGGGGGGGGTTTTGGGGTGTTTTTGGWWWGGGWWWWWWOOOOOOOOOOOOOOOO
OOOOOOOOOOOOOOOWWWGGTGGGGGGGGGGGGGGTTTTGGTTGGTGWWWGWWGSGGGGGGGGGGGGGGGGGGGGTGGTTTTTTTTTTTTTTTGGGGGGGGGGGGGGGGGGGGGGGGTTTGGTGTTTTTGGGGWWGGTGGGGWWWOOOOOOOOOOOOOOOO
OOOOOOOOOOOOOOOWWWGTTGGGGGGGGGGGGGGGGTTTTTTTGGGWWGGGWSSSTGGGGGGGGGGGGGGGGTTTGGGGGGTTTTTTTTTTTTGGGGGGGGGGGGGGGGGGGGTTTTTTGGTGTTTTTTTGGGGTGGGGGGGWWOOOOOOOOOOOOOOOO
OOOOOOOOOOOOOOOWWGGGTGGGGGGGGGGGGGGGGGGTTTTTGGGWGGWGGSGGGGTGGGGGGGGGGGGGTTTGGTGGGGGTTTTTTTGGGgggGGGGGGGGGGGGGGGGGGTTTTTTTGGGTGGGTGTGGTTTGTGTGGGWWOOOOOOOOOOOOOOOO
OOOOOOOOOOOOOOOWGGGTTTGGGGGGGGGGGGGGGGGTGTTGGGGGGWWWGGTGGTTGGGGGGGGGGGGGTTGGTTGGGGGGTTTTTGGGGgggGGGGGGGGGGGGGGGGGGTTTTTTGGGTTGGGGGGGGTGTGGTTTGGGWOOOOOOOOOOOOOOOO
OOOOOOOOOOOOOOOWGGGTTTTGGGGGGGGGGGGGGGGGGGGGTTTTGGWWSTTGGGGGGGGGGGGGGGGTTTGTTTGGGGGGTTTTGGGGGgggGGGGGGGGGGGGGGGGGGGGTTTTGTGGGGGGGGGGGTTGGTGTTGGGGOOOOOOOOOOOOOOOO
OOOOOOOOOOOOOOOGGTTTTGGGGGGGGGGGGGGGGGGGGGGGTTTTGWWSSGGGGGGGGGGGGGGGGGGTTTGTTGGGGGGGTTTGGGGGGgggGGGGGGGGGGGGGGGGGGGGTTTGGTGGGGGTGGGGGTGGGTTTTGGTGOOOOOOOOOOOOOOOO
OOOOOOOOOOOOOOOGGGTTTTTTGGGGGGGGGGGGGGGGGGGGGGGGGWWSGGGGGGGGGGGGGGGGGGGGTGGTGGGGGGGTTTGGGGGGGgggGGGGGGGGGGGGGGGGGGTGGGTGGGGGTGTTGTGGGGTTGGGTGGGGWOOOOOOOOOOOOOOOO
OOOOOOOOOOOOOOOGGGTTTTTTGGGGGGGGGGGGGGGGGGGGGGGGGGWSGTGGGGGGGGGGGGGGGGGGGGTTTGGGGGGTTTGGGGGGGgggGGGGGGGGGGGGGGGGGGGGGGGGGGGTTTTTTTTTGGGGGGGGGTGGGOOOOOOOOOOOOOOOO
OOOOOOOOOOOOOOOWWGGGTTTTTGGGGGGGGGGGGGGGGGGGGTTGGGGWSGGGGGGGGGGGggggggGGTTTTTGGGGGGTTGGGGGGGGGGGGGGGTTTGGTTTGGGGGGGGGGGGGGTTTTTTTTTTTTGGTGGGGGGGWOOOOOOOOOOOOOOOO
OOOOOOOOOOOOOOOWWWGTTTTTTGGGGGGGGGGGGGGGGGGGGTTGGGWWWWGGGGGGGGGGggggggGTTTTTGGGGGGGTTGGGGGGGGGGGGGGTTTTTTTTTTTGGGGGGGGGGTGGGTTTTTTTTTTTTTTTGGGGWWOOOOOOOOOOOOOOOO
OOOOOOOOOOOOOOOWWGGGTTTTTTGGGGGGGGGGGGTGGGGGGGTTGGWWWWSSGGGGGTGGggggggGTTTTTGGGGGGGGGGGGGGGGGGGGGGGTTTTTTTTTTGGGGGGGGGGGTTGGTTTTTTTTTTTTTTTTTGGGGOOOOOOOOOOOOOOOO
OOOOOOOOOOOOOOOWGGGTTTTTTGGGGGGTTTGTGGTGGGGGGGTGGGWWWGWGGGGGTTGGGGGGGGGGTTTGGGGGGGGGGGGGGGGGGGGGTTGTTTTTTTTTTGGGGGGGGGGTGTTGGTTTTTTTTTTTTTTTTGGGGOOOOOOOOOOOOOOOO
OOOOOOOOOOOOOOOWWGGTTTTTTTTGGGTTTTGTTGTGGGGGGGGGGWWSGGGGGTTTTTGGGGGGGGGGGGGGGGGGGGGGGGGGGGGGGGGGGTTTTTTTTTTTTGGGGGGGGGGTTTGGTTTTTTTTTTTTTTTTTTTGGOOOOOOOOOOOOOOOO
OOOOOOOOOOOOOOOWGGGTTTTTTTTGTGTTGGGTTGGGggggggGTGGGGGTTTTTTTTGGGGGGGGGGGGGGGGGGGGGGGGGGGGGGGGGGGTTTTGGTTTTTTTGGGGGGGGGTTTTGTTTTTTTTTGGGTTTTTTTGGGOOOOOOOOOOOOOOOO
OOOOOOOOOOOOOOOWGTGGTTTTTGGGGTGGGGTTTGGGggggggGGGGGGGGTTTTTGGGGGGGGGGGGGGGGGGGGGGGGGGGGGGGGGGGGTTTTGGGGGGGGTTGGTGGGGGGGTTTGGTTTTTTGGGGGGTTTTTTTTTOOOOOOOOOOOOOOOO
OOOOOOOOOOOOOOOWWTTGGGTGGGGGGGGTTTTTTGGGggggggGGGGGGGGGTTTGGGGGGGGGGGGGGGGGGGGGGGGGGGGGGGGGGGGGGTTGGGGGGGGTTGGTTGGGGGGGTTTGGGTTTGGGGGGGGGGGTTTTTTOOOOOOOOOOOOOOOO
OOOOOOOOOOOOOOOWWWTTGGGGGGGGGTTTGGGGGGTGGGGGGGGGGGgggGGGGGGGGGGGGGGGGGGGGGGGGGGGGGGGGGGGGGGGGGGGGGGGGGGGGGGTGGTTTGGGGGGGGGGGGGTTTGGGGGGGGGGTTTTTTOOOOOOOOOOOOOOOO
OOOOOOOOOOOOOOOWWWWTTGGGGGGGGGGGGTTTGGTGGGGGGGGGGGgggGGGGGGGGGGGGGGGGGGGGGGGGGGGGGGGGGGGGGGGGGGGGGGGGGGGGGTTGGTTTGGGGGGGGGGGGGTGGGGGGGGGGGGGTTTTTOOOOOOOOOOOOOOOO
OOOOOOOOOOOOOOOWWWGTGGTTTGGGGGGGTGTTGGGGGGGGGGGGGGgggGGGGGGGGGGGGGGGGGGGGGGGGGGGGGGGGGGGGGGGGGGGGGGGGGGGGGGTGGGTTGGGGGGGGGGGGGGGGGGGGGGGGGGGGGTTTOOOOOOOOOOOOOOOO
OOOOOOOOOOOOOOOWGGWTTGTTGGGGGGGGGGGGGGGGGGGGGGGGGGgggGGGGGGGGGGGTTGTGGGGGGGGGGGGGGGGTTTGGGGGGGGGGGGGGGGGGTTGGTGTGGGGGGGGgggGGGGGGGGGGGGGGGGGGGTTTOOOOOOOOOOOOOOOO
OOOOOOOOOOOOOOOWWWWWTTTGWGGGGGGGGGGGGGGGGGGGGGGGGGgggGGGGGGGGGTTTTTTTGGGGGGGGGGGGGGTTTTTGGGGGGGGGGGGGGGGTTTTGGGGGGGGGGGGgggGGGGGGGGGGGGGGGGGGGTTTOOOOOOOOOOOOOOOO
OOOOOOOOOOOOOOOWWWWWGWWWSGGGGGGGGGGGGGGGGGGGGGGGGGgggGGGGGGGGTTTTTTTTGGGGGGGGGGTTTTTTTTTGGGGGGGGGGGGGGGGTTTTTGGGGGGGGGGGgggGGGGGGGGGGGGGGGGGGGTTGOOOOOOOOOOOOOOOO
OOOOOOOOOOOOOOOWWWWWWWWWSGGGGGGGGGGGGGGGGGGGGGGGGGGGGGGGGGGGTTTTGTTTTTGGGGGGGTTTTTTTTTTTGGGGGGGGGGGGGGTTTTTGGGGGGGGGGGGGgggGGGGGGGGGGGGGGGGGGTTTGOOOOOOOOOOOOOOOO
OOOOOOOOOOOOOOOWWWWWWWWWSGGGGGGGGGGGGGGGGGGGGGGGGGGGGGGGGGGTTTGGGGGGTTGGGGGGGTTTTTTTTTTTTGGGGGGGGGGGGTTTTTTGGTGGGGGGGGGGgggGGGGGGGGGGGGGGGGGTTTTGOOOOOOOOOOOOOOOO
OOOOOOOOOOOOOOOWWWWWWWWGWSGGGTTTGGGGGGGGGGGTTGGGTTTTGGGGGGGGTTGGGGGGTGGGGGGGTTTTTGGGTTTTTGGGGGGGGGGGTTTTTTTGGTGGGGGGGGGGgggGGGGGGGGGGGGGGGGTTTTTGOOOOOOOOOOOOOOOO
OOOOOOOOOOOOOOOWWWWWWGGGGGGGGGTTTTTGGGGGGGGGTTTTTGTTTGGGGGGTTGGGGGGGGGGGGGGGTTTTGGGGGGGTTTGGGGGGGGGGGTTTTTTTGGGGGGGGGGGGGGGGGGGGGGGGGGGGGGGTTTTTTOOOOOOOOOOOOOOOO
OOOOOOOOOOOOOOOWWWWWWGTGGGGGGGGTTTTTGGGGGTGGTTTTTTTTGGGGGGGTTTGGGGGGGGGGGGGGTTTGGGGGGGGTTTTGGGGGGGGGGGTTGTTTgggGGGGGGGGGGGGGTTTGGGGGGGGGGGTTTTTTGOOOOOOOOOOOOOOOO
OOOOOOOOOOOOOOOWWWWWGTTTGGGGTTGGTTTTGGGGGTGTTTTGGGGTTGGGGGGTTTGGGGGGGGGGGGGGTGTGGGGGGGGGTTTGGGGGGGGGGGGGGGGGgggGGGGGGGGGGGGGGTTTGGGGGGTTGGGTTTTGGOOOOOOOOOOOOOOOO
OOOOOOOOOOOOOOOWGGGGGGTTTTTTTGGTGTTGGGGGGGGTGGGGGGGGGGGGGGGGTTTTGGGGGGGGGGGTTTGTGGGGGGGGGTTTGGGGGGGGGGGGGGGGgggGGGGGGGGGGGGGTTTGGGGGGGTTTGTTTTTGGOOOOOOOOOOOOOOOO
OOOOOOOOOOOOOOOWGGGGTTGGGGGGTGTGTTGGGGGGGGTTGGGGGGGGGGGGGGGGGTTTGGGGGGGGGGGTTTTGTGGGGGGGGTTTGGGGGGGGGGGGGGGGgggGGGGGGGGGGGGGGGGGGGGGGTTTTTTTTTTGGOOOOOOOOOOOOOOOO
OOOOOOOOOOOOOOOGGGGGGGGTTGGGGGTTTGGGGGGGGGGTGGGGGGGGGGGGGGGGGTTGGGGGGGGGGGGTTTTTTTGGGGGGGTTTGGGGGGGGGGGGGGGGgggGGGGGGGGGGGGGTTGGGGGGGTTTTTTTTTTGGOOOOOOOOOOOOOOOO
OOOOOOOOOOOOOOOGGGGGGTTTTTTTGGGGGTGGGGGGGTGTGGGGGGGGGGGGGGGGGGGGGGGGGGGGGGGTTTTTTTTGGGGGGGTGGGGGGGGGGGGGGGGGgggGGGGGGGGGGGGGGTTTTGGTTTTTTTTTTTTGGOOOOOOOOOOOOOOOO
OOOOOOOOOOOOOOOGGGGGTTTTTTTTTTTGGTTGGGGGGGGTTGGGGGGGGGGGGGGGGGGGGGGGGGGGGGGGTTTTTTTTGGGGGGGGGGGGGGGTTGGGGGGGGGGGTTTTGGGGGGGGGGGTTGGTTTTTTTTTTTGGGOOOOOOOOOOOOOOOO
OOOOOOOOOOOOOOOGGGTTTTTTTTTTTTTTGTTGGGGGGGGTTTTGTTTTGGGGGGGGGGGGGGGGGGGGGGGTTTTTTTTTGGGGGGGGGGGGGGTGTGGGGGGGGGGGTTTTTTGGGGGGGGGTTGGTTTTTTTTTTGGGWOOOOOOOOOOOOOOOO
OOOOOOOOOOOOOOOGGGTTTTTTTTTTTTTTGGGGGGGGGGGGTTTTTTTGTGGGGGGGGGGGGGGGGGGGGGGGGTGTTTTTTGGGGGGGGGGGGGTTGTGGGGGGGGGGGGGGTTGGGGGGGGGGGGGGTTTTTTTGGGTGGOOOOOOOOOOOOOOOO
OOOOOOOOOOOOOOOGTTTTTTTTTTTTTTTTGGGGGGGGTGGGGGGGGTTTGGGGGGGGGGGGGGGGTTTGGGGGGGGGTTTTTTGGGGGGGGGGGTTTGTGGGGGGGTTGGGTGGGTTGGGGGGGGGGGGTTTTTGGGGWWWWOOOOOOOOOOOOOOOO
OOOOOOOOOOOOOOOGGGTTTTTTGTTGGTTTGGTGTGTTGGGGGGGGGGGGGGGGGGGGGGGGGGGGTTTGGGGGGGGGGTTTTTGGGGGGGGGGGGTTTGGGGGGGTTTTTTTTTGGTTTGGGGGGGTTGGGTGGGGTGWWWWOOOOOOOOOOOOOOOO
OOOOOOOOOOOOOOOTTTTTTTGGGGGGTTTTTGGGGTGTGGGGGGGGGGgggGGGGGGGGGGGGGGGTTTGGGGGGGGGGTTTTTGGGGGGGGGGGTTGGGGGGGGTTTTTTGGTTGTTTTTGGGGGGTTGTGGGTTTGWWWWWOOOOOOOOOOOOOOOO
OOOOOOOOOOOOOOTGTTTTTTGGGGGGGGTGTTTGGTTGGGGGGGGGGGgggGGGGGGGGGGGGGGGTTTTGGGGGGGGTTTTTGGGGGGGGGGGGGGTGGGGGGGGTTTGGGGGGGGTTGGGGGGGTTTGWTTTTTTGWWWWWOOOOOOOOOOOOOOOO
OOOOOOOOOOOOOTTTTTTTTGGGGGGGGGGGTTTTGGGGGGGGGGGGGGgggGGGGGGGGGGGGGGGGTTTGGGGGGGTTTTTTGGGGGGGGGGGGGGGGGGGGGGGGGGGGGGGGTGGGGTGGGGWWWWWGGTTGTTGGWWWWOOOOOOOOOOOOOOOO
OOOOOOOOOOOOOTOTTTTTTGGGGGGGGGGGTTTTTGGGGGGGGGGGGGgggGGGGGGGGGGGGGGGGGTTTGGGGGGTTTTGGGGGGGGGGGGGGGGGGGGGGGGGGGGGGGGGGGTTTTTTTGWWWWWWWWGWTTTTGWWWWOOOOOOOOOOOOOOOO
OOOOOOOOOOOOOTTTTTTTTGGGGGGGGGGTTTTTTGGGGGGGGGGGGGgggGGGGGTTGGGGGGGGGGTTTTGGGGGTTTGGGGGGGGGGGGGGGGGGGGGGGGGGGGGGGGGGGGGGTTTGTGGWWWWWWWWWTGTTGWWWWOOOOOOOOOOOOOOOO
OOOOOOOOOOOOOTTGTTTTTTTGGGGGGGGGTTTTTTTGGGGGGGGGGGgggGGGTTTTGGGGGGGGGGGTTTTTGTTTTTGGGGGGGGGGGGGGGGGGGGGGGGGGGGGGGGGGGGGTTTTGWWWWWWWWWWWGTTTTGWWWWOOOOOOOOOOOOOOOO
OOOOOOOOOOOOOOTTTTTTTTGGGGGGGGGGGGTTTTTGGGGGGGGGGGGGGGGTTTTGGGGGGGGGGGGGGTTTTTTTTTGGGGGGGGGGGGGGGGGGGGGGGGGGGGGGGGGGGTGGGGGWWWWWWWWWWWWGTTGWWWWWWOOOOOOOOOOOOOOOO
OOOOOOOOOOOOOTTGTTTTTTGGGGGGGGGGGGTTTTTGGGGGGGGGGGGGTTTTTGGGGGGGGGGGGGGGGGTTTTTTTGGGGGGGGGGGGTGGGGGGGGGGGGGGGGGGGGGGGTTTGGGGWWWWWWWWWWWWWGGGWWWWWOOOOOOOOOOOOOOOO
OOOOOOOOOOOOOTTTTTTGTGGGGGGGGGGGGGTTGGGGGGGGGGGGGGGGTTTTTGGGGGGGGGGGGGGGGGGTGTTTGGGGGGGGGGGGGTTTGGGGGGGGGGGGGGTTTGTGGTTTTGGGGGWWWWWWGWWWWWWWWWWWWOOOOOOOOOOOOOOOO
OOOOOOOOOOOOOTOGTTTGGGGGGGGGGGGGGGGGgggGGGGGGGGGGGGGGTTTGGGGGGGGGGGGGGGGGGGGGGGGGGGGGGGGGGGGGTTTTGGGGGGGGGGGGTTTTTTGTTTTTTGGGGSSWGWWGGWWWWWWWWWWWOOOOOOOOOOOOOOOO
OOOOOOOOOOOOOTTTTTGGGGGGGGGGGGGGGGGGgggGGGGGGGGGGGGTGGTTGGGGGGGTTGGGGGGGGGGGGGGGGGGGGGGGGGGGGGTTTTGGGGGGGGGWGTTTTTGGTGTGTTTGGGGSGGGGGWWWWWWWWWWWWOOOOOOOOOOOOOOOO
OOOOOOOOOOOOOTTGTTTTGGGGGGGGGGGGGGGGgggGGGGGGGGGGGGTTGTGGGGGGGGTTTGGGGGGGGGGGGGGGGGGGGGGGGGGGGGGTTTGGGGGGGWWGTTTTGGTTTTGTTTTGTGGGTTTGWWWWWWWWWWWWOOOOOOOOOOOOOOOO
OOOOOOOOOOOOOTTTTTTGGGGGGGGGGGGGGGGGgggGGGGGGGGGGGGGTGGTGGGGGTTTTGGGGGGGGGGGGGGGGGGGGGGGTTGGGGGGTTTGGGGGGGGWGWWTTGGTTTTTTTTTTTTGGTTGGWWWGGWWWWWWWOOOOOOOOOOOOOOOO
OOOOOOOOOOOOOTTGTTTGGGGGGGGGGGGGGGGGgggGGGGGGGGGGGGGTTGGTTGTTTTTTGGGGGGGGGGGGGGGGGGGGGGTTTGGGGGGTTTGGGGGGGWWWWWTGGTTTTTTTTTTTGTGTTTGWWWWWGWWWWWWWOOOOOOOOOOOOOOOO
OOOOOOOOOOOOOOTTTTTGGGGGGGGGGGGGGGGGgggGGGGGGGGGGGGGGGGTTTTTTTTGGGGGGGGGGGGGGGGGGGGGGGGGTTTGGGGGTTTggggggGWWWWSGGGGGGTTTGGGGTTTGTTTGGWGGGGGGWWWWWOOOOOOOOOOOOOOOO
OOOOOOOOOOOOOOOGTTTTGGGGGGGGGGTTTGGGGGGGGGGGGGGGGGGGGGGTTTTTTTGGGGGGGGGGGTGGGGGTTGGGGGGGGTTTGGGGTTGggggggGSWGGGGGGGGGGGGGGGGTTTGGTTTGGTTGGGGGWWWWOOOOOOOOOOOOOOOO
OOOOOOOOOOOOOOOTTTTTGGGGGGGGGGTTTTGGGGGGGGGGGGGGGGGGGGGTTTTTTGGggggggGGTTTGGGGGTTGGGGGGGGTTTTTTTTGGggggggGSSSGGGGGGGGGGGGGGGTTTTGGGGGGGGGGGGGGGGWOOOOOOOOOOOOOOOO
OOOOOOOOOOOOOOOGTTTTTTTGGGGGGGTGGGGTGGGGGGGGGGTTGGGTTGGTTTTTGGGggggggGGTTTTGGGGGTTggggggGTGGGTTTGGGGGGGGGGGSSGGGGGGGGGGGGGGGGGTTGGTTTTGGGTTGGGGGGOOOOOOOOOOOOOOOO
OOOOOOOOOOOOOOOGGTTTTTTTTTGGGGGGTGGGGGGGGGGGGGTTTGGTGGTTTGGGGGGggggggGTGSSGGGGGGSGggggggGGGGGGGTGGGGGGGGGGGGGGGGGGGGGGGGGGGGGGGTGGTTTTTTTTTTGGGGGOOOOOOOOOOOOOOOO
OOOOOOOOOOOOOOOWGGTTTTTTTTTTGGGGGGTTTGGGGGGGGGGTTGGGGTTTGGGGGGGGGGGGGGGGSSGGGGGGSGggggggGGTTGGGGGGGGGGGGGGGGGGGGGGGGGGGGGGGGGGTTGTTTTTTTTTTGGGGGGOOOOOOOOOOOOOOOO
OOOOOOOOOOOOOOOWGTTTTTTTTTTTGGGGTTTTTGGGGGGGGGTTTGTTTTTGGGGGGGGGGGGGGGGGSSTGGGGSSGGGGGGGGTTGGGTGGGGGGGGGGGGGGGGGGGGGGGGGGGGGGGGGGTTTTTTTTTTTGGWWWOOOOOOOOOOOOOOOO
OOOOOOOOOOOOOOOWGGGTTTTTTTTTGGGTGTTGTGGGGGGGGGTTTGTTTGGGGGGGGGGGGGGGGGGSSSWGGGGSGTGGGGGGGGGGGGTGGGGGGGGGGGGGGGGGGGGGGGGGGGGTTGGTTTTTTTTTTTTGGGGGWOOOOOOOOOOOOOOOO
OOOOOOOOOOOOOOOWWGGGGGTTTTTTGGGGTTGGGGGGGGGGGGGGTGGTGGGGGGGGGGGGGGGGGGGGGSSSSSSGTTGGGGGGGGGGGGTGGGGTGGGGGGGGGGGGGGGGGGGGGGGGGGTTTTGTTGTGTTTTGGGGGOOOOOOOOOOOOOOOO
OOOOOOOOOOOOOOOWWWGGTGGGGGTGGGGGGGGGGGGGGGGGGGGGGGTGGGGGGGGGGGGGGGGGGTTTGGSSSSSGTTGGGGGGGGGGGGTGTTGTTTGGGGGGGGGGGGGGGTTGGTGGTTTTTTTGGGGGTTTTTTGGWOOOOOOOOOOOOOOOO
OOOOOOOOOOOOOOOWWWGWGGGGGGGGTTTGGGGGGGGGGGGGGGGGGGTGGGGGGGGGGGGGGGGGGTTTTGSSSSGTTTTGGGGGGGGGGGGGTTGGTTTGGGGGGGGGGGGGGGTGGTTTTTTTTGGGGGGGGTTTTTGGGOOOOOOOOOOOOOOOO
OOOOOOOOOOOOOOOWWWWWWWTTTTTGGTGGGGGGGGGGGGGGGGGGGTGGGGGGGGGGGGGGGGGGGGTTTGGSSSGTTTGGGGGGGGTGGTGGGTTGGGGGGGGGGGGGGGGGGGGTGGTTTTTGGGGGGGGGGGTTTTGGGOOOOOOOOOOOOOOOO
OOOOOOOOOOOOOOOWWWWWWWTTTTTTGTGGGGGGGGGGGGGGGGTGGTGGTTGGGGGGGGGGGGGGGGGTTTGGSGTTTGGGGGGGGTTTTTTTGGGTTGGGTTTGGGGGGGGGGGGGgggGGTGGGGGGGGGGGGGTTTTGGOOOOOOOOOOOOOOOO
OOOOOOOOOOOOOOOWWWWWWWGTTTTTGGGGGGGGGGGGGGGGGTTGTTGTTGGGGGGGGGGGGGGGGGGGGGGGGGGTGGGGGGGGGGGTTTTTTTGGTTTGGTTTTGGGGGGGGGGGgggGGGGGGGGGGGGGGGGGTTTGGTOOOOOOOOOOOOOOO
OOOOOOOOOOOOOOOWWWWWWWWGTTTTTGGGGGGGGGGGGGGGTTTGTGGTTTGGGGGGGGGGGGGGGGGGGGGTGTTGGGGGGGGGGGGGGGTTTTTGGTTGGGTTTTGGGGGGGGGGgggGGGGGGGGGGGGGGGGGTTTTGTOOOOOOOOOOOOOOO
OOOOOOOOOOOOOOOWWWWWWWWWTTTTTGGGTTGGGGGGGGTTTTGGTGTTTGGGGGGGGGGGGGGGGGGGGGTGGGTGGGGGGGGGGGGGGGGTTTTTGGTTGGGTTTGGGGGGGGGGgggGGGGGGGGGGGGGGGGGTTTTGTOOOOOOOOOOOOOOO
OOOOOOOOOOOOOOOWWWWWWWWWTTTTGGTTGTTGGGGGGTTTTTGTTGTTTTGGGGGGGGGGGTGGGGGGGGGGGGGGGGGGGGGGGGGGGGGGTTTTGGTTGGTTGGGGGGGGGGGGgggGGGGGGGGGGGGGGGGGGTGTGOTOOOOOOOOOOOOOO
OOOOOOOOOOOOOOOWWWWGGWGGGGTTGTTTTTGGGGGGTTTTTGGTTGTTTGGGGGGGGGGTTTTGGGGGGGGTGGGGGGGGGGGGGGGGGGGGTTTTTGTTGGTTGGGGGGGGGGGGgggGGGGGGGGGGGGGGGGGTTTTGOTOOOOOOOOOOOOOO
OOOOOOOOOOOOOOOWWWWTGGGTTTTGGTTTTGGGGGGGTTTGGGTTGGTTGGGGGGGGGGGGTTTGGGGGGGGTGGGGGGGGGGGGGGGGGGGGGTTTGGTTGGGGGGGGGGGGGGGGGGGGGGGGGGGGGGGGGGGTTTTGTOTOOOOOOOOOOOOOO
OOOOOOOOOOOOOOOWWWWGTGTTTTTGTTTTTTTTTTGTTGGGTGGGGTTGGGGGGGGGGGGGTTTGGGGGGGGGTGGGGGGGGGGGGGGGGGGGGTTTGGTTGGTGGGGGGGGGGGGGTGGGGGGGGGGGGGGGGGGTTTTTGOTTOOOOOOOOOOOOO
OOOOOOOOOOOOOOOWWWWTTGTGTTTGGTTGTTTTGTTTGGTTTTTTGGgggGGGGGGGGGGGTTTTGGGGGGTGGTGGGGGGGGGGGGGGGGGGGGGTTGTTGGTGGGGGGGGGGTTTTGGGGGGGGGGGGGGGGGGTTTTTGOTTOOOOOOOOOOOOO
OOOOOOOOOOOOOOOWWWWWTTTTTTTTGTTTTGTTTTTTGGGTTTTTGGgggGGGGGGGGGGGGTTGGGGGGGTTGGGGGGGGGGTTTGGGGGGGGGGTTGTTGGGGGGGGGGGGGGTTTTGTTGGGGGGGGGGGGGGGTTTTGTOTOOOOOOOOOOOOO
OOOOOOOOOOOOOOOWWWWGGGTTTTTTGGTTTTTGTTTGGGGTTGTGGGgggGGGGGGGGGGGGGGGGGGGGTGTGGGGGGGGGGTTTTGGGGGGGGGTGGTGGGTGGGGGGGGTTTTGTGGGTTTTGGGGGGGGGGGTTTTTGOOOTOOOOOOOOOOOO
OOOOOOOOOOOOOOOWWWWGTGWGTTTTTGGTTTGGTGGGTGGGGGGGGGgggGGGGGGGGGGGGGGGGGGGTGTTGGGTGggggggTTTTGGGGGGGGTGTTGTTTTGGGGGGGTTGTTGGTGTTTGGGGGGGGGGGGTTTTTGOOOOOOOOOOOOOOOO
OOOOOOOOOOOOOOOWWWWWGWWGGWTGTTGGGGGGGGGTTTGGGGGGGGgggGGGGGGGGGGGGGGGGGGGTTGTGGTTGggggggGTTTGGGGGTTTGGGGGGTTTTGGGGGGGGGGGGTTGTTTTTTGTTGGGGGGGTTTTGOTOOOOOOOOOOOOOO
OOOOOOOOOOOOOOOWWWWWWWWWWWGTTTTGGGGTTTTTTGGGGGGGGGgggGGGGGGGGGGGGGGGTGTTTTTGGGGGGggggggGGGGGTTGGGGGGGGGGGTTTTTGTTTTGGTGGTTTGTTTTTTTTTTTGGGGTTTTTGOOOOOOOOOOOOOOOO
OOOOOOOOOOOOOOOWWWWWWWWWWGTGGGTGGTTTTTTTGGGGGGGGGGGGGGGGGGGGGGGGGGGGTTTGGGGGGTGGGGGGGGGGGGGTTTTTGGGGTTTTGGGTGTTTTTGGTGTGTTTGGTTTTTTTTTTTTGTTTTTGGTTOOOOOOOOOOOOOO
OOOOOOOOOOOOOOOWWWWWWWWWWWGGWWGGTTTTTTTGGGGGGGGGGGGGGGTGGGGGGGGGGGGGTTTGGGGTGGGGTGGGGGGGGGGGTTTTTGGGGTTTTTGGTTTTGTGTTTTTTTTGGTTTTTTTTTTTTTTTTTTGGOTOOOOOOOOOOOOOO
OOOOOOOOOOOOOOOWWWWWWWWWWWWWWGGGGTTTTTTGGGGGGGGGGGGGGTTTGGGGGGGGGGGGGTTGTTTTTGTTTGGGGGGGGGGGTTTTTGGGTTTTTTGGGTTTTGGTGTTTTGGGGGTTTTTTTTTTGGGGGGGGGTOOOOOOOOOOOOOOO
OOOOOOOOOOOOOOOWWWWWWWWWWWWWWGGGTTTTGGGGGGGGGGGGGGGGTTTTGGGGGGGGGGGGGTTGTTTTTGGTTTGGGGGGGGGGGGGTGGGGGGTTTTTTGTTTGGGGGGGGGGGTTGGGGTTTTGGGGTTGGGTGTOTOOOOOOOOOOOOOO
OOOOOOOOOOOOOOOWWWWWWWWWWWWWWWGGGTTTTGGGGGGGGGGGGGGGGGTTTTGGGGGGGGGGGGTGTTTGGTGGTTTGGGGGGGGGGGGGGGGGGGGTTTTTGGTGGTGGTTGGTGTTTTGGGGGGGGTTTTGGGGGTTOOOOOOOOOOOOOOOO
OOOOOOOOOOOOOOOWWWWWWWWWWWWWWGGGTTTTGGGGGGGGGGGGGGGGGGGTTTGGGTGGGGGGGGGGTTGGGGGGGGGGTGGGGGGGGGGGGGGGGGGGTTTTGGGGTGGTTTTTTGGTTTGGTTTTGGGGGGGGTTTGTTOOOOOOOOOOOOOOO
OOOOOOOOOOOOOOOWWWWWWWWWWWWWWTGGTTTTTGGGGGGGGGGGGGGGGGGGTTTGGTTGGGGGGTGGTTGGTTGGGGGGTTGGGGGGGGGGGGGGGGGGGTTTTGGTGGTTTTTTTTTTTTTGGGGGGTTTGGGGGTGGGTOOOOOOOOOOOOOOO
OOOOOOOOOOOOOOOWWWWWWWWWWWWGWTGTTTTTTGGGGGGGGGGGGGGGGGGGGTTGGTTTTTGGTTGTTGGGTTTGGGGTTTGGGGGGGGGGGGGGGGGTTTTTTGTGGGTTTTTGGWWWGTTGGGGGGTTTGGGGGGTTGTOOOOOOOOOOOOOOO
OOOOOOOOOOOOOOOWWWWWWWWWWWGGGTGGGTTTTTTTGGGGGGGGGGGGGGGGGTTGTTTTTTTTTGGTGGTTGTGGGGTTTTGGGGGGGGGGGGGGGGGGTTTTTGGGGTTTTTTGWWWWWGTGTTTTTTTTGGGGGGTTGTOOOOOOOOOOOOOOO
OOOOOOOOOOOOOOOWWWWWWWWWWWWWTTTGTTTTTTTGGGGTGGGGGGGGGGGGGGGGGGTTTGTTTGGGGGTTTGGGGTTTTTGGGGGGGGGGGGGGGGGTTTTTTGGTTTTGGWWGWWWWGTTTTTTTGTTTGTTGGGTGGTOOOOOOOOOOOOOOO
OOOOOOOOOOOOOOOWWWWWWWWWWWWWWTTGGTTTTTTTTTTTTGGGGGGGGGGGGGGGGGGGGGGGGGTGTTTTTTGGGGTTTTGGGGGGGGGGGGGGGGGGTTTTTGGTTTTGWWWWWWWWWWGGWWGTTTGGGTTTGTTTGOOOOOOOOOOOOOOOO
OOOOOOOOOOOOOOOWWWWWWWWWWGWGGTTGGTTTTTTTTTTTTGGGGGGGGGGGGTGGGGGGGTGTGGGGTGTTTTGGGTTTGGGGGGGGGGGGGGGGGGGGGTTTTTGTTTTGGWWWWWWWWWWWWWWGTTTTTGGGTTGTGOOOOOOOOOOOOOOOO
OOOOOOOOOOOOOOOWWWWWWWWWGGGTTGTTGGGTTTTTTTTTTTGGGGGGGGGGTTTGGGGGGTTTGGGTTTGTGTGGGGTTTGGGGGGGGGGGGGGGGGGGGTTTTGGTTTTGGWWWWWGGWWWWWWWWGWGTGTTTTTTTGOOOOOOOOOOOOOOOO
OOOOOOOOOOOOOOOWWWWWWWWWWTTTTTTTTGGTTTTTTTTTTTGGGGGGGGGTTTTGGGTGGGGGGGTTTTTGGGGGTTTGGGGGGGGGGGGGGGGGGGGGGTTTTGTTGGTTGGWWGGTGGGWWWWWWWWWWGTTTTGGGGOOOOOOOOOOOOOOOO
OOOOOOOOOOOOOOOWWWWWWWWWGTTTTTTTTGGGTTTTTTTTTTGGGGGGGGGGTTTGGTTTTGTTTGTTTTGGGGGGTTTTTGTTTGGGGGGGGGGGGTGTTTTTGGGTTTGTTGGGTTGTGWGWWWWWWWWWWWGGWGGWWOOOOOOOOOOOOOOOO
OOOOOOOOOOOOOOOWWWWWWWWGGGTTTTTTTGTTGGGGGGTTTGGGGGGGGGGTTTTGGGTTTTTGGTTTTTGGGGGGTTTTTTTTTGGGGGGGGGTTTTTTTTTGGGGGTTTGTTGTGGTGWWWWWWWWWWWWWWWWWWWWWOOOOOOOOOOOOOOOO
OOOOOOOOOOOOOOOWWWWWWWWWWWTTTGGTTGGTGGGWGGGTTTGGGGGGGGTTTTTTGGGGGGGGGGGGTGGGWGGGTTTTTTTTTGGGGGGGGGGTTTTTTTTGGGGTGTGTGTTTTTTGGWWWWWWWWWWWWWWWWWWWWOOOOOOOOOOOOOOOO
OOOOOOOOOOOOOOOWWWWWWWWWWGGGGGWWWGGGGGWWWGGTTTTTGGGGGGTTTTGTGGWGGGWTGWGGTGGGWGGTTTTTTTTTGGGGGGGGTGTTTTTTTTGGGTTGTGTTTGTGTGWGWWWWWWWWWWWWWWWWWWWWWOOOOOOOOOOOOOOOO
OOOOOOOOOOOOOOOWWWWWWWWWWWWWWGWWWGGGGGWWWGGGGTTTTTTGGTTTTGGGGGWGGGWWWWGGGGGWWWGGTTTTTTTTTGGGGGGGTTTTTTTTTGGTTTTTTTGWWTTTGWWWWWWWWWWWWWWWWWWWWWWWWOOOOOOOOOOOOOOOO
OOOOOOOOOOOOOOOWWWWWWWWWWWWWWWWWWWWWWWWWWWGGTTTTTTTTTTTTTGGGWWWTGWWWWWWGWTGWWWGTTTTTTTTTTTGGGGGGTTTTTTTGGGTTTTGTGWWWWWWWWWWWWWWWWWWWWWWWWWWWWWWWWOOOOOOOOOOOOOOOO
OOOOOOOOOOOOOOOWWWWWWWWWWWWWWWWWWWWWWWWWWWGGGTTTTTTTTTTTGGGGWWWWWWWWWWWWGGGGWWGGGTTTTTTTTTTTTTTTTTTTTGGGTTGTTTTGWWWWWWWWWWWWWWWWWWWWWWWWWWWWWWWWWOOOOOOOOOOOOOOOO
OOOOOOOOOOOOOOOWWWWWWWWWWWWWWWWWWWWWWWWWWGGGTTTTTTTTGTGGGGGWWWWWWWWWWWWWWWWWWWWGGGTTTTTTTTTTTTTTTGTTGGGTTGTGTGGWWWWWWWWWWWWWWWWWWWWWWWWWWWWWWWWWWOOOOOOOOOOOOOOOO
OOOOOOOOOOOOOOOOOOOOOOOOOOOOOOOOOOOOOOOOOOOOOOOTOTTOOOOOOOOOOOOOOOOOOOOOOOOOOOOOOOOOOOOOOOTTTTOOTOOOOOOOOOOOOOOOOOOOOOOOOOOOOOOOOOOOOOOOOOOOOOOOOOOOOOOOOOOOOOOOO
OOOOOOOOOOOOOOOOOOOOOOOOOOOOOOOOOOOOOOOOOOOOOOOOOOOOOOOOOOOOOOOOOOOOOOOOOOOOOOOOOOOOOOOOOOOOOOOOOOOOOOOOOOOOOOOOOOOOOOOOOOOOOOOOOOOOOOOOOOOOOOOOOOOOOOOOOOOOOOOOO
OOOOOOOOOOOOOOOOOOOOOOOOOOOOOOOOOOOOOOOOOOOOOOOOOOOOOOOOOOOOOOOOOOOOOOOOOOOOOOOOOOOOOOOOOOOOOOOOOOOOOOOOOOOOOOOOOOOOOOOOOOOOOOOOOOOOOOOOOOOOOOOOOOOOOOOOOOOOOOOOO
OOOOOOOOOOOOOOOOOOOOOOOOOOOOOOOOOOOOOOOOOOOOOOOOOOOOOOOOOOOOOOOOOOOOOOOOOOOOOOOOOOOOOOOOOOOOOOOOOOOOOOOOOOOOOOOOOOOOOOOOOOOOOOOOOOOOOOOOOOOOOOOOOOOOOOOOOOOOOOOOO
OOOOOOOOOOOOOOOOOOOOOOOOOOOOOOOOOOOOOOOOOOOOOOOOOOOOOOOOOOOOOOOOOOOOOOOOOOOOOOOOOOOOOOOOOOOOOOOOOOOOOOOOOOOOOOOOOOOOOOOOOOOOOOOOOOOOOOOOOOOOOOOOOOOOOOOOOOOOOOOOO
OOOOOOOOOOOOOOOOOOOOOOOOOOOOOOOOOOOOOOOOOOOOOOOOOOOOOOOOOOOOOOOOOOOOOOOOOOOOOOOOOOOOOOOOOOOOOOOOOOOOOOOOOOOOOOOOOOOOOOOOOOOOOOOOOOOOOOOOOOOOOOOOOOOOOOOOOOOOOOOOO
OOOOOOOOOOOOOOOOOOOOOOOOOOOOOOOOOOOOOOOOOOOOOOOOOOOOOOOOOOOOOOOOOOOOOOOOOOOOOOOOOOOOOOOOOOOOOOOOOOOOOOOOOOOOOOOOOOOOOOOOOOOOOOOOOOOOOOOOOOOOOOOOOOOOOOOOOOOOOOOOO
OOOOOOOOOOOOOOOOOOOOOOOOOOOOOOOOOOOOOOOOOOOOOOOOOOOOOOOOOOOOOOOOOOOOOOOOOOOOOOOOOOOOOOOOOOOOOOOOOOOOOOOOOOOOOOOOOOOOOOOOOOOOOOOOOOOOOOOOOOOOOOOOOOOOOOOOOOOOOOOOO
OOOOOOOOOOOOOOOOOOOOOOOOOOOOOOOOOOOOOOOOOOOOOOOOOOOOOOOOOOOOOOOOOOOOOOOOOOOOOOOOOOOOOOOOOOOOOOOOOOOOOOOOOOOOOOOOOOOOOOOOOOOOOOOOOOOOOOOOOOOOOOOOOOOOOOOOOOOOOOOOO
OOOOOOOOOOOOOOOOOOOOOOOOOOOOOOOOOOOOOOOOOOOOOOOOOOOOOOOOOOOOOOOOOOOOOOOOOOOOOOOOOOOOOOOOOOOOOOOOOOOOOOOOOOOOOOOOOOOOOOOOOOOOOOOOOOOOOOOOOOOOOOOOOOOOOOOOOOOOOOOOO
OOOOOOOOOOOOOOOOOOOOOOOOOOOOOOOOOOOOOOOOOOOOOOOOOOOOOOOOOOOOOOOOOOOOOOOOOOOOOOOOOOOOOOOOOOOOOOOOOOOOOOOOOOOOOOOOOOOOOOOOOOOOOOOOOOOOOOOOOOOOOOOOOOOOOOOOOOOOOOOOO
OOOOOOOOOOOOOOOOOOOOOOOOOOOOOOOOOOOOOOOOOOOOOOOOOOOOOOOOOOOOOOOOOOOOOOOOOOOOOOOOOOOOOOOOOOOOOOOOOOOOOOOOOOOOOOOOOOOOOOOOOOOOOOOOOOOOOOOOOOOOOOOOOOOOOOOOOOOOOOOOO
OOOOOOOOOOOOOOOOOOOOOOOOOOOOOOOOOOOOOOOOOOOOOOOOOOOOOOOOOOOOOOOOOOOOOOOOOOOOOOOOOOOOOOOOOOOOOOOOOOOOOOOOOOOOOOOOOOOOOOOOOOOOOOOOOOOOOOOOOOOOOOOOOOOOOOOOOOOOOOOOO
OOOOOOOOOOOOOOOOOOOOOOOOOOOOOOOOOOOOOOOOOOOOOOOOOOOOOOOOOOOOOOOOOOOOOOOOOOOOOOOOOOOOOOOOOOOOOOOOOOOOOOOOOOOOOOOOOOOOOOOOOOOOOOOOOOOOOOOOOOOOOOOOOOOOOOOOOOOOOOOOO
